 ****************          **************** 
*////////////////*        *////////////////*
*////////////////*        *////////////////*
*////////////////*        *////////////////*
*////////////////*--------*////////////////*
*////////////////*        *////////////////*
*////////////////*        *////////////////*
*////////////////*        *////////////////*
 ****************          **************** 
