 ************************************************************************                                      ************************************************************************ 
*////////////////////////////////////////////////////////////////////////*                                    *////////////////////////////////////////////////////////////////////////*
*////////////////////////////////////////////////////////////////////////*                                    *////////////////////////////////////////////////////////////////////////*
*////////////////////////////////////////////////////////////////////////*                                    *////////////////////////////////////////////////////////////////////////*
*////////////////////////////////////////////////////////////////////////*                                    *////////////////////////////////////////////////////////////////////////*
*////////////////////////////////////////////////////////////////////////*                                    *////////////////////////////////////////////////////////////////////////*
*////////////////////////////////////////////////////////////////////////*                                    *////////////////////////////////////////////////////////////////////////*
*////////////////////////////////////////////////////////////////////////*                                    *////////////////////////////////////////////////////////////////////////*
*////////////////////////////////////////////////////////////////////////*                                    *////////////////////////////////////////////////////////////////////////*
*////////////////////////////////////////////////////////////////////////*                                    *////////////////////////////////////////////////////////////////////////*
*////////////////////////////////////////////////////////////////////////*                                    *////////////////////////////////////////////////////////////////////////*
*////////////////////////////////////////////////////////////////////////*                                    *////////////////////////////////////////////////////////////////////////*
*////////////////////////////////////////////////////////////////////////*                                    *////////////////////////////////////////////////////////////////////////*
*////////////////////////////////////////////////////////////////////////*                                    *////////////////////////////////////////////////////////////////////////*
*////////////////////////////////////////////////////////////////////////*                                    *////////////////////////////////////////////////////////////////////////*
*////////////////////////////////////////////////////////////////////////*                                    *////////////////////////////////////////////////////////////////////////*
*////////////////////////////////////////////////////////////////////////*                                    *////////////////////////////////////////////////////////////////////////*
*////////////////////////////////////////////////////////////////////////*                                    *////////////////////////////////////////////////////////////////////////*
*////////////////////////////////////////////////////////////////////////*------------------------------------*////////////////////////////////////////////////////////////////////////*
*////////////////////////////////////////////////////////////////////////*                                    *////////////////////////////////////////////////////////////////////////*
*////////////////////////////////////////////////////////////////////////*                                    *////////////////////////////////////////////////////////////////////////*
*////////////////////////////////////////////////////////////////////////*                                    *////////////////////////////////////////////////////////////////////////*
*////////////////////////////////////////////////////////////////////////*                                    *////////////////////////////////////////////////////////////////////////*
*////////////////////////////////////////////////////////////////////////*                                    *////////////////////////////////////////////////////////////////////////*
*////////////////////////////////////////////////////////////////////////*                                    *////////////////////////////////////////////////////////////////////////*
*////////////////////////////////////////////////////////////////////////*                                    *////////////////////////////////////////////////////////////////////////*
*////////////////////////////////////////////////////////////////////////*                                    *////////////////////////////////////////////////////////////////////////*
*////////////////////////////////////////////////////////////////////////*                                    *////////////////////////////////////////////////////////////////////////*
*////////////////////////////////////////////////////////////////////////*                                    *////////////////////////////////////////////////////////////////////////*
*////////////////////////////////////////////////////////////////////////*                                    *////////////////////////////////////////////////////////////////////////*
*////////////////////////////////////////////////////////////////////////*                                    *////////////////////////////////////////////////////////////////////////*
*////////////////////////////////////////////////////////////////////////*                                    *////////////////////////////////////////////////////////////////////////*
*////////////////////////////////////////////////////////////////////////*                                    *////////////////////////////////////////////////////////////////////////*
*////////////////////////////////////////////////////////////////////////*                                    *////////////////////////////////////////////////////////////////////////*
*////////////////////////////////////////////////////////////////////////*                                    *////////////////////////////////////////////////////////////////////////*
*////////////////////////////////////////////////////////////////////////*                                    *////////////////////////////////////////////////////////////////////////*
 ************************************************************************                                      ************************************************************************ 
