 ************************************                    ************************************ 
*////////////////////////////////////*                  *////////////////////////////////////*
*////////////////////////////////////*                  *////////////////////////////////////*
*////////////////////////////////////*                  *////////////////////////////////////*
*////////////////////////////////////*                  *////////////////////////////////////*
*////////////////////////////////////*                  *////////////////////////////////////*
*////////////////////////////////////*                  *////////////////////////////////////*
*////////////////////////////////////*                  *////////////////////////////////////*
*////////////////////////////////////*                  *////////////////////////////////////*
*////////////////////////////////////*------------------*////////////////////////////////////*
*////////////////////////////////////*                  *////////////////////////////////////*
*////////////////////////////////////*                  *////////////////////////////////////*
*////////////////////////////////////*                  *////////////////////////////////////*
*////////////////////////////////////*                  *////////////////////////////////////*
*////////////////////////////////////*                  *////////////////////////////////////*
*////////////////////////////////////*                  *////////////////////////////////////*
*////////////////////////////////////*                  *////////////////////////////////////*
*////////////////////////////////////*                  *////////////////////////////////////*
 ************************************                    ************************************ 
