 ************************              ************************ 
*////////////////////////*            *////////////////////////*
*////////////////////////*            *////////////////////////*
*////////////////////////*            *////////////////////////*
*////////////////////////*            *////////////////////////*
*////////////////////////*            *////////////////////////*
*////////////////////////*------------*////////////////////////*
*////////////////////////*            *////////////////////////*
*////////////////////////*            *////////////////////////*
*////////////////////////*            *////////////////////////*
*////////////////////////*            *////////////////////////*
*////////////////////////*            *////////////////////////*
 ************************              ************************ 
