 ************************************************                          ************************************************ 
*////////////////////////////////////////////////*                        *////////////////////////////////////////////////*
*////////////////////////////////////////////////*                        *////////////////////////////////////////////////*
*////////////////////////////////////////////////*                        *////////////////////////////////////////////////*
*////////////////////////////////////////////////*                        *////////////////////////////////////////////////*
*////////////////////////////////////////////////*                        *////////////////////////////////////////////////*
*////////////////////////////////////////////////*                        *////////////////////////////////////////////////*
*////////////////////////////////////////////////*                        *////////////////////////////////////////////////*
*////////////////////////////////////////////////*                        *////////////////////////////////////////////////*
*////////////////////////////////////////////////*                        *////////////////////////////////////////////////*
*////////////////////////////////////////////////*                        *////////////////////////////////////////////////*
*////////////////////////////////////////////////*                        *////////////////////////////////////////////////*
*////////////////////////////////////////////////*------------------------*////////////////////////////////////////////////*
*////////////////////////////////////////////////*                        *////////////////////////////////////////////////*
*////////////////////////////////////////////////*                        *////////////////////////////////////////////////*
*////////////////////////////////////////////////*                        *////////////////////////////////////////////////*
*////////////////////////////////////////////////*                        *////////////////////////////////////////////////*
*////////////////////////////////////////////////*                        *////////////////////////////////////////////////*
*////////////////////////////////////////////////*                        *////////////////////////////////////////////////*
*////////////////////////////////////////////////*                        *////////////////////////////////////////////////*
*////////////////////////////////////////////////*                        *////////////////////////////////////////////////*
*////////////////////////////////////////////////*                        *////////////////////////////////////////////////*
*////////////////////////////////////////////////*                        *////////////////////////////////////////////////*
*////////////////////////////////////////////////*                        *////////////////////////////////////////////////*
 ************************************************                          ************************************************ 
