 ********      ******** 
*////////*    *////////*
*////////*----*////////*
*////////*    *////////*
 ********      ******** 
