 ************************************************************************************************************                                                        ************************************************************************************************************ 
*////////////////////////////////////////////////////////////////////////////////////////////////////////////*                                                      *////////////////////////////////////////////////////////////////////////////////////////////////////////////*
*////////////////////////////////////////////////////////////////////////////////////////////////////////////*                                                      *////////////////////////////////////////////////////////////////////////////////////////////////////////////*
*////////////////////////////////////////////////////////////////////////////////////////////////////////////*                                                      *////////////////////////////////////////////////////////////////////////////////////////////////////////////*
*////////////////////////////////////////////////////////////////////////////////////////////////////////////*                                                      *////////////////////////////////////////////////////////////////////////////////////////////////////////////*
*////////////////////////////////////////////////////////////////////////////////////////////////////////////*                                                      *////////////////////////////////////////////////////////////////////////////////////////////////////////////*
*////////////////////////////////////////////////////////////////////////////////////////////////////////////*                                                      *////////////////////////////////////////////////////////////////////////////////////////////////////////////*
*////////////////////////////////////////////////////////////////////////////////////////////////////////////*                                                      *////////////////////////////////////////////////////////////////////////////////////////////////////////////*
*////////////////////////////////////////////////////////////////////////////////////////////////////////////*                                                      *////////////////////////////////////////////////////////////////////////////////////////////////////////////*
*////////////////////////////////////////////////////////////////////////////////////////////////////////////*                                                      *////////////////////////////////////////////////////////////////////////////////////////////////////////////*
*////////////////////////////////////////////////////////////////////////////////////////////////////////////*                                                      *////////////////////////////////////////////////////////////////////////////////////////////////////////////*
*////////////////////////////////////////////////////////////////////////////////////////////////////////////*                                                      *////////////////////////////////////////////////////////////////////////////////////////////////////////////*
*////////////////////////////////////////////////////////////////////////////////////////////////////////////*                                                      *////////////////////////////////////////////////////////////////////////////////////////////////////////////*
*////////////////////////////////////////////////////////////////////////////////////////////////////////////*                                                      *////////////////////////////////////////////////////////////////////////////////////////////////////////////*
*////////////////////////////////////////////////////////////////////////////////////////////////////////////*                                                      *////////////////////////////////////////////////////////////////////////////////////////////////////////////*
*////////////////////////////////////////////////////////////////////////////////////////////////////////////*                                                      *////////////////////////////////////////////////////////////////////////////////////////////////////////////*
*////////////////////////////////////////////////////////////////////////////////////////////////////////////*                                                      *////////////////////////////////////////////////////////////////////////////////////////////////////////////*
*////////////////////////////////////////////////////////////////////////////////////////////////////////////*                                                      *////////////////////////////////////////////////////////////////////////////////////////////////////////////*
*////////////////////////////////////////////////////////////////////////////////////////////////////////////*                                                      *////////////////////////////////////////////////////////////////////////////////////////////////////////////*
*////////////////////////////////////////////////////////////////////////////////////////////////////////////*                                                      *////////////////////////////////////////////////////////////////////////////////////////////////////////////*
*////////////////////////////////////////////////////////////////////////////////////////////////////////////*                                                      *////////////////////////////////////////////////////////////////////////////////////////////////////////////*
*////////////////////////////////////////////////////////////////////////////////////////////////////////////*                                                      *////////////////////////////////////////////////////////////////////////////////////////////////////////////*
*////////////////////////////////////////////////////////////////////////////////////////////////////////////*                                                      *////////////////////////////////////////////////////////////////////////////////////////////////////////////*
*////////////////////////////////////////////////////////////////////////////////////////////////////////////*                                                      *////////////////////////////////////////////////////////////////////////////////////////////////////////////*
*////////////////////////////////////////////////////////////////////////////////////////////////////////////*                                                      *////////////////////////////////////////////////////////////////////////////////////////////////////////////*
*////////////////////////////////////////////////////////////////////////////////////////////////////////////*                                                      *////////////////////////////////////////////////////////////////////////////////////////////////////////////*
*////////////////////////////////////////////////////////////////////////////////////////////////////////////*                                                      *////////////////////////////////////////////////////////////////////////////////////////////////////////////*
*////////////////////////////////////////////////////////////////////////////////////////////////////////////*------------------------------------------------------*////////////////////////////////////////////////////////////////////////////////////////////////////////////*
*////////////////////////////////////////////////////////////////////////////////////////////////////////////*                                                      *////////////////////////////////////////////////////////////////////////////////////////////////////////////*
*////////////////////////////////////////////////////////////////////////////////////////////////////////////*                                                      *////////////////////////////////////////////////////////////////////////////////////////////////////////////*
*////////////////////////////////////////////////////////////////////////////////////////////////////////////*                                                      *////////////////////////////////////////////////////////////////////////////////////////////////////////////*
*////////////////////////////////////////////////////////////////////////////////////////////////////////////*                                                      *////////////////////////////////////////////////////////////////////////////////////////////////////////////*
*////////////////////////////////////////////////////////////////////////////////////////////////////////////*                                                      *////////////////////////////////////////////////////////////////////////////////////////////////////////////*
*////////////////////////////////////////////////////////////////////////////////////////////////////////////*                                                      *////////////////////////////////////////////////////////////////////////////////////////////////////////////*
*////////////////////////////////////////////////////////////////////////////////////////////////////////////*                                                      *////////////////////////////////////////////////////////////////////////////////////////////////////////////*
*////////////////////////////////////////////////////////////////////////////////////////////////////////////*                                                      *////////////////////////////////////////////////////////////////////////////////////////////////////////////*
*////////////////////////////////////////////////////////////////////////////////////////////////////////////*                                                      *////////////////////////////////////////////////////////////////////////////////////////////////////////////*
*////////////////////////////////////////////////////////////////////////////////////////////////////////////*                                                      *////////////////////////////////////////////////////////////////////////////////////////////////////////////*
*////////////////////////////////////////////////////////////////////////////////////////////////////////////*                                                      *////////////////////////////////////////////////////////////////////////////////////////////////////////////*
*////////////////////////////////////////////////////////////////////////////////////////////////////////////*                                                      *////////////////////////////////////////////////////////////////////////////////////////////////////////////*
*////////////////////////////////////////////////////////////////////////////////////////////////////////////*                                                      *////////////////////////////////////////////////////////////////////////////////////////////////////////////*
*////////////////////////////////////////////////////////////////////////////////////////////////////////////*                                                      *////////////////////////////////////////////////////////////////////////////////////////////////////////////*
*////////////////////////////////////////////////////////////////////////////////////////////////////////////*                                                      *////////////////////////////////////////////////////////////////////////////////////////////////////////////*
*////////////////////////////////////////////////////////////////////////////////////////////////////////////*                                                      *////////////////////////////////////////////////////////////////////////////////////////////////////////////*
*////////////////////////////////////////////////////////////////////////////////////////////////////////////*                                                      *////////////////////////////////////////////////////////////////////////////////////////////////////////////*
*////////////////////////////////////////////////////////////////////////////////////////////////////////////*                                                      *////////////////////////////////////////////////////////////////////////////////////////////////////////////*
*////////////////////////////////////////////////////////////////////////////////////////////////////////////*                                                      *////////////////////////////////////////////////////////////////////////////////////////////////////////////*
*////////////////////////////////////////////////////////////////////////////////////////////////////////////*                                                      *////////////////////////////////////////////////////////////////////////////////////////////////////////////*
*////////////////////////////////////////////////////////////////////////////////////////////////////////////*                                                      *////////////////////////////////////////////////////////////////////////////////////////////////////////////*
*////////////////////////////////////////////////////////////////////////////////////////////////////////////*                                                      *////////////////////////////////////////////////////////////////////////////////////////////////////////////*
*////////////////////////////////////////////////////////////////////////////////////////////////////////////*                                                      *////////////////////////////////////////////////////////////////////////////////////////////////////////////*
*////////////////////////////////////////////////////////////////////////////////////////////////////////////*                                                      *////////////////////////////////////////////////////////////////////////////////////////////////////////////*
*////////////////////////////////////////////////////////////////////////////////////////////////////////////*                                                      *////////////////////////////////////////////////////////////////////////////////////////////////////////////*
*////////////////////////////////////////////////////////////////////////////////////////////////////////////*                                                      *////////////////////////////////////////////////////////////////////////////////////////////////////////////*
 ************************************************************************************************************                                                        ************************************************************************************************************ 
