 ****************************************************************                                  **************************************************************** 
*////////////////////////////////////////////////////////////////*                                *////////////////////////////////////////////////////////////////*
*////////////////////////////////////////////////////////////////*                                *////////////////////////////////////////////////////////////////*
*////////////////////////////////////////////////////////////////*                                *////////////////////////////////////////////////////////////////*
*////////////////////////////////////////////////////////////////*                                *////////////////////////////////////////////////////////////////*
*////////////////////////////////////////////////////////////////*                                *////////////////////////////////////////////////////////////////*
*////////////////////////////////////////////////////////////////*                                *////////////////////////////////////////////////////////////////*
*////////////////////////////////////////////////////////////////*                                *////////////////////////////////////////////////////////////////*
*////////////////////////////////////////////////////////////////*                                *////////////////////////////////////////////////////////////////*
*////////////////////////////////////////////////////////////////*                                *////////////////////////////////////////////////////////////////*
*////////////////////////////////////////////////////////////////*                                *////////////////////////////////////////////////////////////////*
*////////////////////////////////////////////////////////////////*                                *////////////////////////////////////////////////////////////////*
*////////////////////////////////////////////////////////////////*                                *////////////////////////////////////////////////////////////////*
*////////////////////////////////////////////////////////////////*                                *////////////////////////////////////////////////////////////////*
*////////////////////////////////////////////////////////////////*                                *////////////////////////////////////////////////////////////////*
*////////////////////////////////////////////////////////////////*                                *////////////////////////////////////////////////////////////////*
*////////////////////////////////////////////////////////////////*--------------------------------*////////////////////////////////////////////////////////////////*
*////////////////////////////////////////////////////////////////*                                *////////////////////////////////////////////////////////////////*
*////////////////////////////////////////////////////////////////*                                *////////////////////////////////////////////////////////////////*
*////////////////////////////////////////////////////////////////*                                *////////////////////////////////////////////////////////////////*
*////////////////////////////////////////////////////////////////*                                *////////////////////////////////////////////////////////////////*
*////////////////////////////////////////////////////////////////*                                *////////////////////////////////////////////////////////////////*
*////////////////////////////////////////////////////////////////*                                *////////////////////////////////////////////////////////////////*
*////////////////////////////////////////////////////////////////*                                *////////////////////////////////////////////////////////////////*
*////////////////////////////////////////////////////////////////*                                *////////////////////////////////////////////////////////////////*
*////////////////////////////////////////////////////////////////*                                *////////////////////////////////////////////////////////////////*
*////////////////////////////////////////////////////////////////*                                *////////////////////////////////////////////////////////////////*
*////////////////////////////////////////////////////////////////*                                *////////////////////////////////////////////////////////////////*
*////////////////////////////////////////////////////////////////*                                *////////////////////////////////////////////////////////////////*
*////////////////////////////////////////////////////////////////*                                *////////////////////////////////////////////////////////////////*
*////////////////////////////////////////////////////////////////*                                *////////////////////////////////////////////////////////////////*
*////////////////////////////////////////////////////////////////*                                *////////////////////////////////////////////////////////////////*
 ****************************************************************                                  **************************************************************** 
