 ************************************************************************************************************************************                                                                    ************************************************************************************************************************************ 
*////////////////////////////////////////////////////////////////////////////////////////////////////////////////////////////////////*                                                                  *////////////////////////////////////////////////////////////////////////////////////////////////////////////////////////////////////*
*////////////////////////////////////////////////////////////////////////////////////////////////////////////////////////////////////*                                                                  *////////////////////////////////////////////////////////////////////////////////////////////////////////////////////////////////////*
*////////////////////////////////////////////////////////////////////////////////////////////////////////////////////////////////////*                                                                  *////////////////////////////////////////////////////////////////////////////////////////////////////////////////////////////////////*
*////////////////////////////////////////////////////////////////////////////////////////////////////////////////////////////////////*                                                                  *////////////////////////////////////////////////////////////////////////////////////////////////////////////////////////////////////*
*////////////////////////////////////////////////////////////////////////////////////////////////////////////////////////////////////*                                                                  *////////////////////////////////////////////////////////////////////////////////////////////////////////////////////////////////////*
*////////////////////////////////////////////////////////////////////////////////////////////////////////////////////////////////////*                                                                  *////////////////////////////////////////////////////////////////////////////////////////////////////////////////////////////////////*
*////////////////////////////////////////////////////////////////////////////////////////////////////////////////////////////////////*                                                                  *////////////////////////////////////////////////////////////////////////////////////////////////////////////////////////////////////*
*////////////////////////////////////////////////////////////////////////////////////////////////////////////////////////////////////*                                                                  *////////////////////////////////////////////////////////////////////////////////////////////////////////////////////////////////////*
*////////////////////////////////////////////////////////////////////////////////////////////////////////////////////////////////////*                                                                  *////////////////////////////////////////////////////////////////////////////////////////////////////////////////////////////////////*
*////////////////////////////////////////////////////////////////////////////////////////////////////////////////////////////////////*                                                                  *////////////////////////////////////////////////////////////////////////////////////////////////////////////////////////////////////*
*////////////////////////////////////////////////////////////////////////////////////////////////////////////////////////////////////*                                                                  *////////////////////////////////////////////////////////////////////////////////////////////////////////////////////////////////////*
*////////////////////////////////////////////////////////////////////////////////////////////////////////////////////////////////////*                                                                  *////////////////////////////////////////////////////////////////////////////////////////////////////////////////////////////////////*
*////////////////////////////////////////////////////////////////////////////////////////////////////////////////////////////////////*                                                                  *////////////////////////////////////////////////////////////////////////////////////////////////////////////////////////////////////*
*////////////////////////////////////////////////////////////////////////////////////////////////////////////////////////////////////*                                                                  *////////////////////////////////////////////////////////////////////////////////////////////////////////////////////////////////////*
*////////////////////////////////////////////////////////////////////////////////////////////////////////////////////////////////////*                                                                  *////////////////////////////////////////////////////////////////////////////////////////////////////////////////////////////////////*
*////////////////////////////////////////////////////////////////////////////////////////////////////////////////////////////////////*                                                                  *////////////////////////////////////////////////////////////////////////////////////////////////////////////////////////////////////*
*////////////////////////////////////////////////////////////////////////////////////////////////////////////////////////////////////*                                                                  *////////////////////////////////////////////////////////////////////////////////////////////////////////////////////////////////////*
*////////////////////////////////////////////////////////////////////////////////////////////////////////////////////////////////////*                                                                  *////////////////////////////////////////////////////////////////////////////////////////////////////////////////////////////////////*
*////////////////////////////////////////////////////////////////////////////////////////////////////////////////////////////////////*                                                                  *////////////////////////////////////////////////////////////////////////////////////////////////////////////////////////////////////*
*////////////////////////////////////////////////////////////////////////////////////////////////////////////////////////////////////*                                                                  *////////////////////////////////////////////////////////////////////////////////////////////////////////////////////////////////////*
*////////////////////////////////////////////////////////////////////////////////////////////////////////////////////////////////////*                                                                  *////////////////////////////////////////////////////////////////////////////////////////////////////////////////////////////////////*
*////////////////////////////////////////////////////////////////////////////////////////////////////////////////////////////////////*                                                                  *////////////////////////////////////////////////////////////////////////////////////////////////////////////////////////////////////*
*////////////////////////////////////////////////////////////////////////////////////////////////////////////////////////////////////*                                                                  *////////////////////////////////////////////////////////////////////////////////////////////////////////////////////////////////////*
*////////////////////////////////////////////////////////////////////////////////////////////////////////////////////////////////////*                                                                  *////////////////////////////////////////////////////////////////////////////////////////////////////////////////////////////////////*
*////////////////////////////////////////////////////////////////////////////////////////////////////////////////////////////////////*                                                                  *////////////////////////////////////////////////////////////////////////////////////////////////////////////////////////////////////*
*////////////////////////////////////////////////////////////////////////////////////////////////////////////////////////////////////*                                                                  *////////////////////////////////////////////////////////////////////////////////////////////////////////////////////////////////////*
*////////////////////////////////////////////////////////////////////////////////////////////////////////////////////////////////////*                                                                  *////////////////////////////////////////////////////////////////////////////////////////////////////////////////////////////////////*
*////////////////////////////////////////////////////////////////////////////////////////////////////////////////////////////////////*                                                                  *////////////////////////////////////////////////////////////////////////////////////////////////////////////////////////////////////*
*////////////////////////////////////////////////////////////////////////////////////////////////////////////////////////////////////*                                                                  *////////////////////////////////////////////////////////////////////////////////////////////////////////////////////////////////////*
*////////////////////////////////////////////////////////////////////////////////////////////////////////////////////////////////////*                                                                  *////////////////////////////////////////////////////////////////////////////////////////////////////////////////////////////////////*
*////////////////////////////////////////////////////////////////////////////////////////////////////////////////////////////////////*                                                                  *////////////////////////////////////////////////////////////////////////////////////////////////////////////////////////////////////*
*////////////////////////////////////////////////////////////////////////////////////////////////////////////////////////////////////*                                                                  *////////////////////////////////////////////////////////////////////////////////////////////////////////////////////////////////////*
*////////////////////////////////////////////////////////////////////////////////////////////////////////////////////////////////////*------------------------------------------------------------------*////////////////////////////////////////////////////////////////////////////////////////////////////////////////////////////////////*
*////////////////////////////////////////////////////////////////////////////////////////////////////////////////////////////////////*                                                                  *////////////////////////////////////////////////////////////////////////////////////////////////////////////////////////////////////*
*////////////////////////////////////////////////////////////////////////////////////////////////////////////////////////////////////*                                                                  *////////////////////////////////////////////////////////////////////////////////////////////////////////////////////////////////////*
*////////////////////////////////////////////////////////////////////////////////////////////////////////////////////////////////////*                                                                  *////////////////////////////////////////////////////////////////////////////////////////////////////////////////////////////////////*
*////////////////////////////////////////////////////////////////////////////////////////////////////////////////////////////////////*                                                                  *////////////////////////////////////////////////////////////////////////////////////////////////////////////////////////////////////*
*////////////////////////////////////////////////////////////////////////////////////////////////////////////////////////////////////*                                                                  *////////////////////////////////////////////////////////////////////////////////////////////////////////////////////////////////////*
*////////////////////////////////////////////////////////////////////////////////////////////////////////////////////////////////////*                                                                  *////////////////////////////////////////////////////////////////////////////////////////////////////////////////////////////////////*
*////////////////////////////////////////////////////////////////////////////////////////////////////////////////////////////////////*                                                                  *////////////////////////////////////////////////////////////////////////////////////////////////////////////////////////////////////*
*////////////////////////////////////////////////////////////////////////////////////////////////////////////////////////////////////*                                                                  *////////////////////////////////////////////////////////////////////////////////////////////////////////////////////////////////////*
*////////////////////////////////////////////////////////////////////////////////////////////////////////////////////////////////////*                                                                  *////////////////////////////////////////////////////////////////////////////////////////////////////////////////////////////////////*
*////////////////////////////////////////////////////////////////////////////////////////////////////////////////////////////////////*                                                                  *////////////////////////////////////////////////////////////////////////////////////////////////////////////////////////////////////*
*////////////////////////////////////////////////////////////////////////////////////////////////////////////////////////////////////*                                                                  *////////////////////////////////////////////////////////////////////////////////////////////////////////////////////////////////////*
*////////////////////////////////////////////////////////////////////////////////////////////////////////////////////////////////////*                                                                  *////////////////////////////////////////////////////////////////////////////////////////////////////////////////////////////////////*
*////////////////////////////////////////////////////////////////////////////////////////////////////////////////////////////////////*                                                                  *////////////////////////////////////////////////////////////////////////////////////////////////////////////////////////////////////*
*////////////////////////////////////////////////////////////////////////////////////////////////////////////////////////////////////*                                                                  *////////////////////////////////////////////////////////////////////////////////////////////////////////////////////////////////////*
*////////////////////////////////////////////////////////////////////////////////////////////////////////////////////////////////////*                                                                  *////////////////////////////////////////////////////////////////////////////////////////////////////////////////////////////////////*
*////////////////////////////////////////////////////////////////////////////////////////////////////////////////////////////////////*                                                                  *////////////////////////////////////////////////////////////////////////////////////////////////////////////////////////////////////*
*////////////////////////////////////////////////////////////////////////////////////////////////////////////////////////////////////*                                                                  *////////////////////////////////////////////////////////////////////////////////////////////////////////////////////////////////////*
*////////////////////////////////////////////////////////////////////////////////////////////////////////////////////////////////////*                                                                  *////////////////////////////////////////////////////////////////////////////////////////////////////////////////////////////////////*
*////////////////////////////////////////////////////////////////////////////////////////////////////////////////////////////////////*                                                                  *////////////////////////////////////////////////////////////////////////////////////////////////////////////////////////////////////*
*////////////////////////////////////////////////////////////////////////////////////////////////////////////////////////////////////*                                                                  *////////////////////////////////////////////////////////////////////////////////////////////////////////////////////////////////////*
*////////////////////////////////////////////////////////////////////////////////////////////////////////////////////////////////////*                                                                  *////////////////////////////////////////////////////////////////////////////////////////////////////////////////////////////////////*
*////////////////////////////////////////////////////////////////////////////////////////////////////////////////////////////////////*                                                                  *////////////////////////////////////////////////////////////////////////////////////////////////////////////////////////////////////*
*////////////////////////////////////////////////////////////////////////////////////////////////////////////////////////////////////*                                                                  *////////////////////////////////////////////////////////////////////////////////////////////////////////////////////////////////////*
*////////////////////////////////////////////////////////////////////////////////////////////////////////////////////////////////////*                                                                  *////////////////////////////////////////////////////////////////////////////////////////////////////////////////////////////////////*
*////////////////////////////////////////////////////////////////////////////////////////////////////////////////////////////////////*                                                                  *////////////////////////////////////////////////////////////////////////////////////////////////////////////////////////////////////*
*////////////////////////////////////////////////////////////////////////////////////////////////////////////////////////////////////*                                                                  *////////////////////////////////////////////////////////////////////////////////////////////////////////////////////////////////////*
*////////////////////////////////////////////////////////////////////////////////////////////////////////////////////////////////////*                                                                  *////////////////////////////////////////////////////////////////////////////////////////////////////////////////////////////////////*
*////////////////////////////////////////////////////////////////////////////////////////////////////////////////////////////////////*                                                                  *////////////////////////////////////////////////////////////////////////////////////////////////////////////////////////////////////*
*////////////////////////////////////////////////////////////////////////////////////////////////////////////////////////////////////*                                                                  *////////////////////////////////////////////////////////////////////////////////////////////////////////////////////////////////////*
*////////////////////////////////////////////////////////////////////////////////////////////////////////////////////////////////////*                                                                  *////////////////////////////////////////////////////////////////////////////////////////////////////////////////////////////////////*
*////////////////////////////////////////////////////////////////////////////////////////////////////////////////////////////////////*                                                                  *////////////////////////////////////////////////////////////////////////////////////////////////////////////////////////////////////*
*////////////////////////////////////////////////////////////////////////////////////////////////////////////////////////////////////*                                                                  *////////////////////////////////////////////////////////////////////////////////////////////////////////////////////////////////////*
 ************************************************************************************************************************************                                                                    ************************************************************************************************************************************ 
