 ****************************                **************************** 
*////////////////////////////*              *////////////////////////////*
*////////////////////////////*              *////////////////////////////*
*////////////////////////////*              *////////////////////////////*
*////////////////////////////*              *////////////////////////////*
*////////////////////////////*              *////////////////////////////*
*////////////////////////////*              *////////////////////////////*
*////////////////////////////*--------------*////////////////////////////*
*////////////////////////////*              *////////////////////////////*
*////////////////////////////*              *////////////////////////////*
*////////////////////////////*              *////////////////////////////*
*////////////////////////////*              *////////////////////////////*
*////////////////////////////*              *////////////////////////////*
*////////////////////////////*              *////////////////////////////*
 ****************************                **************************** 
