 ************************************************************************************                                            ************************************************************************************ 
*////////////////////////////////////////////////////////////////////////////////////*                                          *////////////////////////////////////////////////////////////////////////////////////*
*////////////////////////////////////////////////////////////////////////////////////*                                          *////////////////////////////////////////////////////////////////////////////////////*
*////////////////////////////////////////////////////////////////////////////////////*                                          *////////////////////////////////////////////////////////////////////////////////////*
*////////////////////////////////////////////////////////////////////////////////////*                                          *////////////////////////////////////////////////////////////////////////////////////*
*////////////////////////////////////////////////////////////////////////////////////*                                          *////////////////////////////////////////////////////////////////////////////////////*
*////////////////////////////////////////////////////////////////////////////////////*                                          *////////////////////////////////////////////////////////////////////////////////////*
*////////////////////////////////////////////////////////////////////////////////////*                                          *////////////////////////////////////////////////////////////////////////////////////*
*////////////////////////////////////////////////////////////////////////////////////*                                          *////////////////////////////////////////////////////////////////////////////////////*
*////////////////////////////////////////////////////////////////////////////////////*                                          *////////////////////////////////////////////////////////////////////////////////////*
*////////////////////////////////////////////////////////////////////////////////////*                                          *////////////////////////////////////////////////////////////////////////////////////*
*////////////////////////////////////////////////////////////////////////////////////*                                          *////////////////////////////////////////////////////////////////////////////////////*
*////////////////////////////////////////////////////////////////////////////////////*                                          *////////////////////////////////////////////////////////////////////////////////////*
*////////////////////////////////////////////////////////////////////////////////////*                                          *////////////////////////////////////////////////////////////////////////////////////*
*////////////////////////////////////////////////////////////////////////////////////*                                          *////////////////////////////////////////////////////////////////////////////////////*
*////////////////////////////////////////////////////////////////////////////////////*                                          *////////////////////////////////////////////////////////////////////////////////////*
*////////////////////////////////////////////////////////////////////////////////////*                                          *////////////////////////////////////////////////////////////////////////////////////*
*////////////////////////////////////////////////////////////////////////////////////*                                          *////////////////////////////////////////////////////////////////////////////////////*
*////////////////////////////////////////////////////////////////////////////////////*                                          *////////////////////////////////////////////////////////////////////////////////////*
*////////////////////////////////////////////////////////////////////////////////////*                                          *////////////////////////////////////////////////////////////////////////////////////*
*////////////////////////////////////////////////////////////////////////////////////*                                          *////////////////////////////////////////////////////////////////////////////////////*
*////////////////////////////////////////////////////////////////////////////////////*------------------------------------------*////////////////////////////////////////////////////////////////////////////////////*
*////////////////////////////////////////////////////////////////////////////////////*                                          *////////////////////////////////////////////////////////////////////////////////////*
*////////////////////////////////////////////////////////////////////////////////////*                                          *////////////////////////////////////////////////////////////////////////////////////*
*////////////////////////////////////////////////////////////////////////////////////*                                          *////////////////////////////////////////////////////////////////////////////////////*
*////////////////////////////////////////////////////////////////////////////////////*                                          *////////////////////////////////////////////////////////////////////////////////////*
*////////////////////////////////////////////////////////////////////////////////////*                                          *////////////////////////////////////////////////////////////////////////////////////*
*////////////////////////////////////////////////////////////////////////////////////*                                          *////////////////////////////////////////////////////////////////////////////////////*
*////////////////////////////////////////////////////////////////////////////////////*                                          *////////////////////////////////////////////////////////////////////////////////////*
*////////////////////////////////////////////////////////////////////////////////////*                                          *////////////////////////////////////////////////////////////////////////////////////*
*////////////////////////////////////////////////////////////////////////////////////*                                          *////////////////////////////////////////////////////////////////////////////////////*
*////////////////////////////////////////////////////////////////////////////////////*                                          *////////////////////////////////////////////////////////////////////////////////////*
*////////////////////////////////////////////////////////////////////////////////////*                                          *////////////////////////////////////////////////////////////////////////////////////*
*////////////////////////////////////////////////////////////////////////////////////*                                          *////////////////////////////////////////////////////////////////////////////////////*
*////////////////////////////////////////////////////////////////////////////////////*                                          *////////////////////////////////////////////////////////////////////////////////////*
*////////////////////////////////////////////////////////////////////////////////////*                                          *////////////////////////////////////////////////////////////////////////////////////*
*////////////////////////////////////////////////////////////////////////////////////*                                          *////////////////////////////////////////////////////////////////////////////////////*
*////////////////////////////////////////////////////////////////////////////////////*                                          *////////////////////////////////////////////////////////////////////////////////////*
*////////////////////////////////////////////////////////////////////////////////////*                                          *////////////////////////////////////////////////////////////////////////////////////*
*////////////////////////////////////////////////////////////////////////////////////*                                          *////////////////////////////////////////////////////////////////////////////////////*
*////////////////////////////////////////////////////////////////////////////////////*                                          *////////////////////////////////////////////////////////////////////////////////////*
*////////////////////////////////////////////////////////////////////////////////////*                                          *////////////////////////////////////////////////////////////////////////////////////*
 ************************************************************************************                                            ************************************************************************************ 
