 ********************************************************************************************                                                ******************************************************************************************** 
*////////////////////////////////////////////////////////////////////////////////////////////*                                              *////////////////////////////////////////////////////////////////////////////////////////////*
*////////////////////////////////////////////////////////////////////////////////////////////*                                              *////////////////////////////////////////////////////////////////////////////////////////////*
*////////////////////////////////////////////////////////////////////////////////////////////*                                              *////////////////////////////////////////////////////////////////////////////////////////////*
*////////////////////////////////////////////////////////////////////////////////////////////*                                              *////////////////////////////////////////////////////////////////////////////////////////////*
*////////////////////////////////////////////////////////////////////////////////////////////*                                              *////////////////////////////////////////////////////////////////////////////////////////////*
*////////////////////////////////////////////////////////////////////////////////////////////*                                              *////////////////////////////////////////////////////////////////////////////////////////////*
*////////////////////////////////////////////////////////////////////////////////////////////*                                              *////////////////////////////////////////////////////////////////////////////////////////////*
*////////////////////////////////////////////////////////////////////////////////////////////*                                              *////////////////////////////////////////////////////////////////////////////////////////////*
*////////////////////////////////////////////////////////////////////////////////////////////*                                              *////////////////////////////////////////////////////////////////////////////////////////////*
*////////////////////////////////////////////////////////////////////////////////////////////*                                              *////////////////////////////////////////////////////////////////////////////////////////////*
*////////////////////////////////////////////////////////////////////////////////////////////*                                              *////////////////////////////////////////////////////////////////////////////////////////////*
*////////////////////////////////////////////////////////////////////////////////////////////*                                              *////////////////////////////////////////////////////////////////////////////////////////////*
*////////////////////////////////////////////////////////////////////////////////////////////*                                              *////////////////////////////////////////////////////////////////////////////////////////////*
*////////////////////////////////////////////////////////////////////////////////////////////*                                              *////////////////////////////////////////////////////////////////////////////////////////////*
*////////////////////////////////////////////////////////////////////////////////////////////*                                              *////////////////////////////////////////////////////////////////////////////////////////////*
*////////////////////////////////////////////////////////////////////////////////////////////*                                              *////////////////////////////////////////////////////////////////////////////////////////////*
*////////////////////////////////////////////////////////////////////////////////////////////*                                              *////////////////////////////////////////////////////////////////////////////////////////////*
*////////////////////////////////////////////////////////////////////////////////////////////*                                              *////////////////////////////////////////////////////////////////////////////////////////////*
*////////////////////////////////////////////////////////////////////////////////////////////*                                              *////////////////////////////////////////////////////////////////////////////////////////////*
*////////////////////////////////////////////////////////////////////////////////////////////*                                              *////////////////////////////////////////////////////////////////////////////////////////////*
*////////////////////////////////////////////////////////////////////////////////////////////*                                              *////////////////////////////////////////////////////////////////////////////////////////////*
*////////////////////////////////////////////////////////////////////////////////////////////*                                              *////////////////////////////////////////////////////////////////////////////////////////////*
*////////////////////////////////////////////////////////////////////////////////////////////*----------------------------------------------*////////////////////////////////////////////////////////////////////////////////////////////*
*////////////////////////////////////////////////////////////////////////////////////////////*                                              *////////////////////////////////////////////////////////////////////////////////////////////*
*////////////////////////////////////////////////////////////////////////////////////////////*                                              *////////////////////////////////////////////////////////////////////////////////////////////*
*////////////////////////////////////////////////////////////////////////////////////////////*                                              *////////////////////////////////////////////////////////////////////////////////////////////*
*////////////////////////////////////////////////////////////////////////////////////////////*                                              *////////////////////////////////////////////////////////////////////////////////////////////*
*////////////////////////////////////////////////////////////////////////////////////////////*                                              *////////////////////////////////////////////////////////////////////////////////////////////*
*////////////////////////////////////////////////////////////////////////////////////////////*                                              *////////////////////////////////////////////////////////////////////////////////////////////*
*////////////////////////////////////////////////////////////////////////////////////////////*                                              *////////////////////////////////////////////////////////////////////////////////////////////*
*////////////////////////////////////////////////////////////////////////////////////////////*                                              *////////////////////////////////////////////////////////////////////////////////////////////*
*////////////////////////////////////////////////////////////////////////////////////////////*                                              *////////////////////////////////////////////////////////////////////////////////////////////*
*////////////////////////////////////////////////////////////////////////////////////////////*                                              *////////////////////////////////////////////////////////////////////////////////////////////*
*////////////////////////////////////////////////////////////////////////////////////////////*                                              *////////////////////////////////////////////////////////////////////////////////////////////*
*////////////////////////////////////////////////////////////////////////////////////////////*                                              *////////////////////////////////////////////////////////////////////////////////////////////*
*////////////////////////////////////////////////////////////////////////////////////////////*                                              *////////////////////////////////////////////////////////////////////////////////////////////*
*////////////////////////////////////////////////////////////////////////////////////////////*                                              *////////////////////////////////////////////////////////////////////////////////////////////*
*////////////////////////////////////////////////////////////////////////////////////////////*                                              *////////////////////////////////////////////////////////////////////////////////////////////*
*////////////////////////////////////////////////////////////////////////////////////////////*                                              *////////////////////////////////////////////////////////////////////////////////////////////*
*////////////////////////////////////////////////////////////////////////////////////////////*                                              *////////////////////////////////////////////////////////////////////////////////////////////*
*////////////////////////////////////////////////////////////////////////////////////////////*                                              *////////////////////////////////////////////////////////////////////////////////////////////*
*////////////////////////////////////////////////////////////////////////////////////////////*                                              *////////////////////////////////////////////////////////////////////////////////////////////*
*////////////////////////////////////////////////////////////////////////////////////////////*                                              *////////////////////////////////////////////////////////////////////////////////////////////*
*////////////////////////////////////////////////////////////////////////////////////////////*                                              *////////////////////////////////////////////////////////////////////////////////////////////*
*////////////////////////////////////////////////////////////////////////////////////////////*                                              *////////////////////////////////////////////////////////////////////////////////////////////*
 ********************************************************************************************                                                ******************************************************************************************** 
