 ********************************************************                              ******************************************************** 
*////////////////////////////////////////////////////////*                            *////////////////////////////////////////////////////////*
*////////////////////////////////////////////////////////*                            *////////////////////////////////////////////////////////*
*////////////////////////////////////////////////////////*                            *////////////////////////////////////////////////////////*
*////////////////////////////////////////////////////////*                            *////////////////////////////////////////////////////////*
*////////////////////////////////////////////////////////*                            *////////////////////////////////////////////////////////*
*////////////////////////////////////////////////////////*                            *////////////////////////////////////////////////////////*
*////////////////////////////////////////////////////////*                            *////////////////////////////////////////////////////////*
*////////////////////////////////////////////////////////*                            *////////////////////////////////////////////////////////*
*////////////////////////////////////////////////////////*                            *////////////////////////////////////////////////////////*
*////////////////////////////////////////////////////////*                            *////////////////////////////////////////////////////////*
*////////////////////////////////////////////////////////*                            *////////////////////////////////////////////////////////*
*////////////////////////////////////////////////////////*                            *////////////////////////////////////////////////////////*
*////////////////////////////////////////////////////////*                            *////////////////////////////////////////////////////////*
*////////////////////////////////////////////////////////*----------------------------*////////////////////////////////////////////////////////*
*////////////////////////////////////////////////////////*                            *////////////////////////////////////////////////////////*
*////////////////////////////////////////////////////////*                            *////////////////////////////////////////////////////////*
*////////////////////////////////////////////////////////*                            *////////////////////////////////////////////////////////*
*////////////////////////////////////////////////////////*                            *////////////////////////////////////////////////////////*
*////////////////////////////////////////////////////////*                            *////////////////////////////////////////////////////////*
*////////////////////////////////////////////////////////*                            *////////////////////////////////////////////////////////*
*////////////////////////////////////////////////////////*                            *////////////////////////////////////////////////////////*
*////////////////////////////////////////////////////////*                            *////////////////////////////////////////////////////////*
*////////////////////////////////////////////////////////*                            *////////////////////////////////////////////////////////*
*////////////////////////////////////////////////////////*                            *////////////////////////////////////////////////////////*
*////////////////////////////////////////////////////////*                            *////////////////////////////////////////////////////////*
*////////////////////////////////////////////////////////*                            *////////////////////////////////////////////////////////*
*////////////////////////////////////////////////////////*                            *////////////////////////////////////////////////////////*
 ********************************************************                              ******************************************************** 
