 ************        ************ 
*////////////*      *////////////*
*////////////*      *////////////*
*////////////*------*////////////*
*////////////*      *////////////*
*////////////*      *////////////*
 ************        ************ 
