 ********************************************                        ******************************************** 
*////////////////////////////////////////////*                      *////////////////////////////////////////////*
*////////////////////////////////////////////*                      *////////////////////////////////////////////*
*////////////////////////////////////////////*                      *////////////////////////////////////////////*
*////////////////////////////////////////////*                      *////////////////////////////////////////////*
*////////////////////////////////////////////*                      *////////////////////////////////////////////*
*////////////////////////////////////////////*                      *////////////////////////////////////////////*
*////////////////////////////////////////////*                      *////////////////////////////////////////////*
*////////////////////////////////////////////*                      *////////////////////////////////////////////*
*////////////////////////////////////////////*                      *////////////////////////////////////////////*
*////////////////////////////////////////////*                      *////////////////////////////////////////////*
*////////////////////////////////////////////*----------------------*////////////////////////////////////////////*
*////////////////////////////////////////////*                      *////////////////////////////////////////////*
*////////////////////////////////////////////*                      *////////////////////////////////////////////*
*////////////////////////////////////////////*                      *////////////////////////////////////////////*
*////////////////////////////////////////////*                      *////////////////////////////////////////////*
*////////////////////////////////////////////*                      *////////////////////////////////////////////*
*////////////////////////////////////////////*                      *////////////////////////////////////////////*
*////////////////////////////////////////////*                      *////////////////////////////////////////////*
*////////////////////////////////////////////*                      *////////////////////////////////////////////*
*////////////////////////////////////////////*                      *////////////////////////////////////////////*
*////////////////////////////////////////////*                      *////////////////////////////////////////////*
 ********************************************                        ******************************************** 
