......#############......
......#...........#......
......#...........#......
......#...........#......
......#...........#......
......#...........#......
......#...........#......
......#...........#......
......#...........#......
......#...........#......
......#...........#......
......#...........#......
#######...........#######
.#.....................#.
..#...................#..
...#.................#...
....#...............#....
.....#.............#.....
......#...........#......
.......#.........#.......
........#.......#........
.........#.....#.........
..........#...#..........
...........#.#...........
............#............
