...........#######################...........
...........#.....................#...........
...........#.....................#...........
...........#.....................#...........
...........#.....................#...........
...........#.....................#...........
...........#.....................#...........
...........#.....................#...........
...........#.....................#...........
...........#.....................#...........
...........#.....................#...........
...........#.....................#...........
...........#.....................#...........
...........#.....................#...........
...........#.....................#...........
...........#.....................#...........
...........#.....................#...........
...........#.....................#...........
...........#.....................#...........
...........#.....................#...........
...........#.....................#...........
...........#.....................#...........
############.....................############
.#.........................................#.
..#.......................................#..
...#.....................................#...
....#...................................#....
.....#.................................#.....
......#...............................#......
.......#.............................#.......
........#...........................#........
.........#.........................#.........
..........#.......................#..........
...........#.....................#...........
............#...................#............
.............#.................#.............
..............#...............#..............
...............#.............#...............
................#...........#................
.................#.........#.................
..................#.......#..................
...................#.....#...................
....................#...#....................
.....................#.#.....................
......................#......................
