.....###########.....
.....#.........#.....
.....#.........#.....
.....#.........#.....
.....#.........#.....
.....#.........#.....
.....#.........#.....
.....#.........#.....
.....#.........#.....
.....#.........#.....
######.........######
.#.................#.
..#...............#..
...#.............#...
....#...........#....
.....#.........#.....
......#.......#......
.......#.....#.......
........#...#........
.........#.#.........
..........#..........
