.............###########################.............
.............#.........................#.............
.............#.........................#.............
.............#.........................#.............
.............#.........................#.............
.............#.........................#.............
.............#.........................#.............
.............#.........................#.............
.............#.........................#.............
.............#.........................#.............
.............#.........................#.............
.............#.........................#.............
.............#.........................#.............
.............#.........................#.............
.............#.........................#.............
.............#.........................#.............
.............#.........................#.............
.............#.........................#.............
.............#.........................#.............
.............#.........................#.............
.............#.........................#.............
.............#.........................#.............
.............#.........................#.............
.............#.........................#.............
.............#.........................#.............
.............#.........................#.............
##############.........................##############
.#.................................................#.
..#...............................................#..
...#.............................................#...
....#...........................................#....
.....#.........................................#.....
......#.......................................#......
.......#.....................................#.......
........#...................................#........
.........#.................................#.........
..........#...............................#..........
...........#.............................#...........
............#...........................#............
.............#.........................#.............
..............#.......................#..............
...............#.....................#...............
................#...................#................
.................#.................#.................
..................#...............#..................
...................#.............#...................
....................#...........#....................
.....................#.........#.....................
......................#.......#......................
.......................#.....#.......................
........................#...#........................
.........................#.#.........................
..........................#..........................
