............#########################............
............#.......................#............
............#.......................#............
............#.......................#............
............#.......................#............
............#.......................#............
............#.......................#............
............#.......................#............
............#.......................#............
............#.......................#............
............#.......................#............
............#.......................#............
............#.......................#............
............#.......................#............
............#.......................#............
............#.......................#............
............#.......................#............
............#.......................#............
............#.......................#............
............#.......................#............
............#.......................#............
............#.......................#............
............#.......................#............
............#.......................#............
#############.......................#############
.#.............................................#.
..#...........................................#..
...#.........................................#...
....#.......................................#....
.....#.....................................#.....
......#...................................#......
.......#.................................#.......
........#...............................#........
.........#.............................#.........
..........#...........................#..........
...........#.........................#...........
............#.......................#............
.............#.....................#.............
..............#...................#..............
...............#.................#...............
................#...............#................
.................#.............#.................
..................#...........#..................
...................#.........#...................
....................#.......#....................
.....................#.....#.....................
......................#...#......................
.......................#.#.......................
........................#........................
