..........#####################..........
..........#...................#..........
..........#...................#..........
..........#...................#..........
..........#...................#..........
..........#...................#..........
..........#...................#..........
..........#...................#..........
..........#...................#..........
..........#...................#..........
..........#...................#..........
..........#...................#..........
..........#...................#..........
..........#...................#..........
..........#...................#..........
..........#...................#..........
..........#...................#..........
..........#...................#..........
..........#...................#..........
..........#...................#..........
###########...................###########
.#.....................................#.
..#...................................#..
...#.................................#...
....#...............................#....
.....#.............................#.....
......#...........................#......
.......#.........................#.......
........#.......................#........
.........#.....................#.........
..........#...................#..........
...........#.................#...........
............#...............#............
.............#.............#.............
..............#...........#..............
...............#.........#...............
................#.......#................
.................#.....#.................
..................#...#..................
...................#.#...................
....................#....................
