....#########....
....#.......#....
....#.......#....
....#.......#....
....#.......#....
....#.......#....
....#.......#....
....#.......#....
#####.......#####
.#.............#.
..#...........#..
...#.........#...
....#.......#....
.....#.....#.....
......#...#......
.......#.#.......
........#........
