..#####..
..#...#..
..#...#..
..#...#..
###...###
.#.....#.
..#...#..
...#.#...
....#....
