..............#############################..............
..............#...........................#..............
..............#...........................#..............
..............#...........................#..............
..............#...........................#..............
..............#...........................#..............
..............#...........................#..............
..............#...........................#..............
..............#...........................#..............
..............#...........................#..............
..............#...........................#..............
..............#...........................#..............
..............#...........................#..............
..............#...........................#..............
..............#...........................#..............
..............#...........................#..............
..............#...........................#..............
..............#...........................#..............
..............#...........................#..............
..............#...........................#..............
..............#...........................#..............
..............#...........................#..............
..............#...........................#..............
..............#...........................#..............
..............#...........................#..............
..............#...........................#..............
..............#...........................#..............
..............#...........................#..............
###############...........................###############
.#.....................................................#.
..#...................................................#..
...#.................................................#...
....#...............................................#....
.....#.............................................#.....
......#...........................................#......
.......#.........................................#.......
........#.......................................#........
.........#.....................................#.........
..........#...................................#..........
...........#.................................#...........
............#...............................#............
.............#.............................#.............
..............#...........................#..............
...............#.........................#...............
................#.......................#................
.................#.....................#.................
..................#...................#..................
...................#.................#...................
....................#...............#....................
.....................#.............#.....................
......................#...........#......................
.......................#.........#.......................
........................#.......#........................
.........................#.....#.........................
..........................#...#..........................
...........................#.#...........................
............................#............................
