.........###################.........
.........#.................#.........
.........#.................#.........
.........#.................#.........
.........#.................#.........
.........#.................#.........
.........#.................#.........
.........#.................#.........
.........#.................#.........
.........#.................#.........
.........#.................#.........
.........#.................#.........
.........#.................#.........
.........#.................#.........
.........#.................#.........
.........#.................#.........
.........#.................#.........
.........#.................#.........
##########.................##########
.#.................................#.
..#...............................#..
...#.............................#...
....#...........................#....
.....#.........................#.....
......#.......................#......
.......#.....................#.......
........#...................#........
.........#.................#.........
..........#...............#..........
...........#.............#...........
............#...........#............
.............#.........#.............
..............#.......#..............
...............#.....#...............
................#...#................
.................#.#.................
..................#..................
