........#################........
........#...............#........
........#...............#........
........#...............#........
........#...............#........
........#...............#........
........#...............#........
........#...............#........
........#...............#........
........#...............#........
........#...............#........
........#...............#........
........#...............#........
........#...............#........
........#...............#........
........#...............#........
#########...............#########
.#.............................#.
..#...........................#..
...#.........................#...
....#.......................#....
.....#.....................#.....
......#...................#......
.......#.................#.......
........#...............#........
.........#.............#.........
..........#...........#..........
...........#.........#...........
............#.......#............
.............#.....#.............
..............#...#..............
...............#.#...............
................#................
