.......###############.......
.......#.............#.......
.......#.............#.......
.......#.............#.......
.......#.............#.......
.......#.............#.......
.......#.............#.......
.......#.............#.......
.......#.............#.......
.......#.............#.......
.......#.............#.......
.......#.............#.......
.......#.............#.......
.......#.............#.......
########.............########
.#.........................#.
..#.......................#..
...#.....................#...
....#...................#....
.....#.................#.....
......#...............#......
.......#.............#.......
........#...........#........
.........#.........#.........
..........#.......#..........
...........#.....#...........
............#...#............
.............#.#.............
..............#..............
