...#######...
...#.....#...
...#.....#...
...#.....#...
...#.....#...
...#.....#...
####.....####
.#.........#.
..#.......#..
...#.....#...
....#...#....
.....#.#.....
......#......
