697698699
787788789
796797798
877878879
886887888
895896897
967968969
976977978
985986987
