577578579
586587588
595596597
667668669
676677678
685686687
757758759
766767768
775776777
856857858
865866867
955956957
