589689789
598698798
679779879
688788888
697797897
769869969
778878978
787887987
796896996
