557558559
566567568
575576577
656657658
665666667
755756757
