679689699
769779789
778788798
859869879
868878888
877887897
958968978
967977987
976986996
