587588589
596597598
677678679
686687688
695696697
767768769
776777778
785786787
857858859
866867868
875876877
956957958
965966967
