595597599
685687689
775777779
865867869
955957959
