579579579
588588588
597597597
669669669
678678678
687687687
696696696
759759759
768768768
777777777
786786786
795795795
858858858
867867867
876876876
885885885
957957957
966966966
975975975
