558558558
567567567
576576576
585585585
657657657
666666666
675675675
756756756
765765765
855855855
