21|31==213|1
21|3==2|13
21|23==2|123
21|32==213|2
21|312==213|12
31|21==312|1
31|2==3|12
31|23==3|123
31|23==312|3
31|213==312|13
2|31==23|1
2|13==21|3
2|123==21|23
2|312==23|12
12|31==123|1
12|3==1|23
12|32==123|2
12|13==1|213
3|21==32|1
3|12==31|2
3|123==31|23
3|213==32|13
1|23==12|3
1|32==13|2
1|312==13|12
1|213==12|13
23|12==2|312
23|1==2|31
32|1==3|21
32|13==3|213
13|2==1|32
13|12==1|312
123|2==12|32
123|1==12|31
312|3==31|23
312|1==31|21
312|13==31|213
213|2==21|32
213|12==21|312
213|1==21|31
