163265367
172274376
253355457
262364466
271373475
343445547
352454556
361463565
433535637
442544646
451553655
523625727
532634736
541643745
