477477477
567567567
576576576
657657657
666666666
675675675
747747747
756756756
765765765
774774774
