114115116
123124125
132133134
141142143
213214215
222223224
231232233
312313314
321322323
411412413
