167267367
176276376
257357457
266366466
275375475
347447547
356456556
365465565
374474574
437537637
446546646
455555655
464564664
473573673
527627727
536636736
545645745
554654754
563663763
572672772
