125126127
134135136
143144145
152153154
161162163
215216217
224225226
233234235
242243244
251252253
314315316
323324325
332333334
341342343
413414415
422423424
431432433
512513514
521522523
611612613
