133135137
142144146
151153155
223225227
232234236
241243245
313315317
322324326
331333335
412414416
421423425
511513515
