171274377
261364467
351454557
441544647
531634737
