114225336
123234345
132243354
141252363
213324435
222333444
231342453
312423534
321432543
411522633
