------------*------------
-----------***-----------
----------*****----------
---------*******---------
--------*********--------
-------***********-------
------*************------
-----***************-----
----*****************----
---*******************---
--*********************--
-***********************-
*************************
|***********************|
|***********************|
|***********************|
|***********************|
|***********************|
|***********************|
|***********************|
|***********************|
|***********************|
|***********************|
|***********************|
|***********************|
|***********************|
|***********************|
|***********************|
|***********************|
|***********************|
|***********************|
|***********************|
|***********************|
|***********************|
|***********************|
|***********************|
|***********************|
|***********************|
