--------*--------
-------***-------
------*****------
-----*******-----
----*********----
---***********---
--*************--
-***************-
*****************
|***************|
|***************|
|***************|
|***************|
|***************|
|***************|
|***************|
|***************|
|***************|
|***************|
|***************|
|***************|
|***************|
|***************|
|***************|
|***************|
|***************|
