-------*-------
------***------
-----*****-----
----*******----
---*********---
--***********--
-*************-
***************
|*************|
|*************|
|*************|
|*************|
|*************|
|*************|
|*************|
|*************|
|*************|
|*************|
|*************|
|*************|
|*************|
|*************|
|*************|
