-----------*-----------
----------***----------
---------*****---------
--------*******--------
-------*********-------
------***********------
-----*************-----
----***************----
---*****************---
--*******************--
-*********************-
***********************
|*********************|
|*********************|
|*********************|
|*********************|
|*********************|
|*********************|
|*********************|
|*********************|
|*********************|
|*********************|
|*********************|
|*********************|
|*********************|
|*********************|
|*********************|
|*********************|
|*********************|
|*********************|
|*********************|
|*********************|
|*********************|
|*********************|
|*********************|
