-------------*-------------
------------***------------
-----------*****-----------
----------*******----------
---------*********---------
--------***********--------
-------*************-------
------***************------
-----*****************-----
----*******************----
---*********************---
--***********************--
-*************************-
***************************
|*************************|
|*************************|
|*************************|
|*************************|
|*************************|
|*************************|
|*************************|
|*************************|
|*************************|
|*************************|
|*************************|
|*************************|
|*************************|
|*************************|
|*************************|
|*************************|
|*************************|
|*************************|
|*************************|
|*************************|
|*************************|
|*************************|
|*************************|
|*************************|
|*************************|
|*************************|
|*************************|
