------*------
-----***-----
----*****----
---*******---
--*********--
-***********-
*************
|***********|
|***********|
|***********|
|***********|
|***********|
|***********|
|***********|
|***********|
|***********|
|***********|
|***********|
|***********|
|***********|
