----*----
---***---
--*****--
-*******-
*********
|*******|
|*******|
|*******|
|*******|
|*******|
|*******|
|*******|
|*******|
|*******|
