----------*----------
---------***---------
--------*****--------
-------*******-------
------*********------
-----***********-----
----*************----
---***************---
--*****************--
-*******************-
*********************
|*******************|
|*******************|
|*******************|
|*******************|
|*******************|
|*******************|
|*******************|
|*******************|
|*******************|
|*******************|
|*******************|
|*******************|
|*******************|
|*******************|
|*******************|
|*******************|
|*******************|
|*******************|
|*******************|
|*******************|
|*******************|
