-----*-----
----***----
---*****---
--*******--
-*********-
***********
|*********|
|*********|
|*********|
|*********|
|*********|
|*********|
|*********|
|*********|
|*********|
|*********|
|*********|
