---------*---------
--------***--------
-------*****-------
------*******------
-----*********-----
----***********----
---*************---
--***************--
-*****************-
*******************
|*****************|
|*****************|
|*****************|
|*****************|
|*****************|
|*****************|
|*****************|
|*****************|
|*****************|
|*****************|
|*****************|
|*****************|
|*****************|
|*****************|
|*****************|
|*****************|
|*****************|
|*****************|
|*****************|
