\************************/
.\**********************/.
..\********************/..
...\******************/...
....\****************/....
.....\**************/.....
......\************/......
.......\**********/.......
........\********/........
.........\******/.........
..........\****/..........
...........\**/...........
............\/............
............||............
............||............
............||............
............||............
............||............
............||............
............||............
............||............
............||............
............||............
............||............
--------------------------
--------------------------
