\************************************/
.\**********************************/.
..\********************************/..
...\******************************/...
....\****************************/....
.....\**************************/.....
......\************************/......
.......\**********************/.......
........\********************/........
.........\******************/.........
..........\****************/..........
...........\**************/...........
............\************/............
.............\**********/.............
..............\********/..............
...............\******/...............
................\****/................
.................\**/.................
..................\/..................
..................||..................
..................||..................
..................||..................
..................||..................
..................||..................
..................||..................
..................||..................
..................||..................
..................||..................
..................||..................
..................||..................
..................||..................
..................||..................
..................||..................
..................||..................
..................||..................
..................||..................
--------------------------------------
--------------------------------------
