\****************/
.\**************/.
..\************/..
...\**********/...
....\********/....
.....\******/.....
......\****/......
.......\**/.......
........\/........
........||........
........||........
........||........
........||........
........||........
........||........
........||........
------------------
------------------
