\**********/
.\********/.
..\******/..
...\****/...
....\**/....
.....\/.....
.....||.....
.....||.....
.....||.....
.....||.....
------------
------------
