\********/
.\******/.
..\****/..
...\**/...
....\/....
....||....
....||....
....||....
....||....
----------
