\**************/
.\************/.
..\**********/..
...\********/...
....\******/....
.....\****/.....
......\**/......
.......\/.......
.......||.......
.......||.......
.......||.......
.......||.......
.......||.......
.......||.......
----------------
----------------
