\****************************/
.\**************************/.
..\************************/..
...\**********************/...
....\********************/....
.....\******************/.....
......\****************/......
.......\**************/.......
........\************/........
.........\**********/.........
..........\********/..........
...........\******/...........
............\****/............
.............\**/.............
..............\/..............
..............||..............
..............||..............
..............||..............
..............||..............
..............||..............
..............||..............
..............||..............
..............||..............
..............||..............
..............||..............
..............||..............
..............||..............
..............||..............
------------------------------
------------------------------
