\************/
.\**********/.
..\********/..
...\******/...
....\****/....
.....\**/.....
......\/......
......||......
......||......
......||......
......||......
......||......
--------------
--------------
