\**********************************************************/
.\********************************************************/.
..\******************************************************/..
...\****************************************************/...
....\**************************************************/....
.....\************************************************/.....
......\**********************************************/......
.......\********************************************/.......
........\******************************************/........
.........\****************************************/.........
..........\**************************************/..........
...........\************************************/...........
............\**********************************/............
.............\********************************/.............
..............\******************************/..............
...............\****************************/...............
................\**************************/................
.................\************************/.................
..................\**********************/..................
...................\********************/...................
....................\******************/....................
.....................\****************/.....................
......................\**************/......................
.......................\************/.......................
........................\**********/........................
.........................\********/.........................
..........................\******/..........................
...........................\****/...........................
............................\**/............................
.............................\/.............................
.............................||.............................
.............................||.............................
.............................||.............................
.............................||.............................
.............................||.............................
.............................||.............................
.............................||.............................
.............................||.............................
.............................||.............................
.............................||.............................
.............................||.............................
.............................||.............................
.............................||.............................
.............................||.............................
.............................||.............................
.............................||.............................
.............................||.............................
.............................||.............................
.............................||.............................
.............................||.............................
.............................||.............................
.............................||.............................
.............................||.............................
.............................||.............................
.............................||.............................
.............................||.............................
.............................||.............................
.............................||.............................
------------------------------------------------------------
------------------------------------------------------------
