\**************************************/
.\************************************/.
..\**********************************/..
...\********************************/...
....\******************************/....
.....\****************************/.....
......\**************************/......
.......\************************/.......
........\**********************/........
.........\********************/.........
..........\******************/..........
...........\****************/...........
............\**************/............
.............\************/.............
..............\**********/..............
...............\********/...............
................\******/................
.................\****/.................
..................\**/..................
...................\/...................
...................||...................
...................||...................
...................||...................
...................||...................
...................||...................
...................||...................
...................||...................
...................||...................
...................||...................
...................||...................
...................||...................
...................||...................
...................||...................
...................||...................
...................||...................
...................||...................
...................||...................
...................||...................
----------------------------------------
----------------------------------------
