\******/
.\****/.
..\**/..
...\/...
...||...
...||...
...||...
--------
