.......................................
.......................................
...................*...................
..............***********..............
...........*****************...........
..........*******************..........
.........*********************.........
.......*************************.......
.......*************************.......
......***************************......
.....*****************************.....
....*******************************....
....*******************************....
....*******************************....
...*********************************...
...*********************************...
...*********************************...
...*********************************...
...*********************************...
..***********************************..
...*********************************...
...*********************************...
...*********************************...
...*********************************...
...*********************************...
....*******************************....
....*******************************....
....*******************************....
.....*****************************.....
......***************************......
.......*************************.......
.......*************************.......
.........*********************.........
..........*******************..........
...........*****************...........
..............***********..............
...................*...................
.......................................
.......................................
