.................*.................
............***********............
.........*****************.........
........*******************........
.......*********************.......
.....*************************.....
.....*************************.....
....***************************....
...*****************************...
..*******************************..
..*******************************..
..*******************************..
.*********************************.
.*********************************.
.*********************************.
.*********************************.
.*********************************.
***********************************
.*********************************.
.*********************************.
.*********************************.
.*********************************.
.*********************************.
..*******************************..
..*******************************..
..*******************************..
...*****************************...
....***************************....
.....*************************.....
.....*************************.....
.......*********************.......
........*******************........
.........*****************.........
............***********............
.................*.................
