.........
....*....
..*****..
..*****..
.*******.
..*****..
..*****..
....*....
.........
