.............................
.............................
..............*..............
..........*********..........
........*************........
.......***************.......
......*****************......
.....*******************.....
....*********************....
....*********************....
...***********************...
...***********************...
...***********************...
...***********************...
..*************************..
...***********************...
...***********************...
...***********************...
...***********************...
....*********************....
....*********************....
.....*******************.....
......*****************......
.......***************.......
........*************........
..........*********..........
..............*..............
.............................
.............................
