.............
.............
......*......
....*****....
...*******...
...*******...
..*********..
...*******...
...*******...
....*****....
......*......
.............
.............
