.......*.......
....*******....
...*********...
..***********..
.*************.
.*************.
.*************.
***************
.*************.
.*************.
.*************.
..***********..
...*********...
....*******....
.......*.......
