.................
.................
.................
.................
.................
........*........
......*****......
......*****......
.....*******.....
......*****......
......*****......
........*........
.................
.................
.................
.................
.................
