...................
...................
...................
.........*.........
......*******......
.....*********.....
....***********....
....***********....
....***********....
...*************...
....***********....
....***********....
....***********....
.....*********.....
......*******......
.........*.........
...................
...................
...................
