.......................
...........*...........
.......*********.......
.....*************.....
....***************....
...*****************...
...*****************...
..*******************..
..*******************..
..*******************..
..*******************..
.*********************.
..*******************..
..*******************..
..*******************..
..*******************..
...*****************...
...*****************...
....***************....
.....*************.....
.......*********.......
...........*...........
.......................
