65|535==6|5535
65|535==655|35
65|535==6553|5
65|535==6553|5
65|5535==655|535
65|55==655|5
65|55==655|5
65|5==6|55
65|35==6|535
65|5==6|55
6|535==65|35
6|5535==65|535
6|5535==655|35
6|5535==6553|5
6|5535==6553|5
6|55==65|5
6|55==65|5
55|535==5|5535
55|535==5|5535
55|35==5|535
55|35==5|535
5|535==55|35
5|5535==55|535
655|535==65|5535
655|5==65|55
655|35==65|535
655|35==6|5535
655|35==6553|5
655|35==6553|5
655|5==65|55
6553|5==65|535
6553|5==6|5535
6553|5==655|35
6553|5==65|535
6553|5==6|5535
6553|5==655|35
5|535==55|35
5|5535==55|535
