**************       **************
*////////////*       *////////////*
*////////////*       *////////////*
*////////////*|||||||*////////////*
*////////////*       *////////////*
*////////////*       *////////////*
**************       **************
