**************************************************************************************************************                                                       **************************************************************************************************************
*////////////////////////////////////////////////////////////////////////////////////////////////////////////*                                                       *////////////////////////////////////////////////////////////////////////////////////////////////////////////*
*////////////////////////////////////////////////////////////////////////////////////////////////////////////*                                                       *////////////////////////////////////////////////////////////////////////////////////////////////////////////*
*////////////////////////////////////////////////////////////////////////////////////////////////////////////*                                                       *////////////////////////////////////////////////////////////////////////////////////////////////////////////*
*////////////////////////////////////////////////////////////////////////////////////////////////////////////*                                                       *////////////////////////////////////////////////////////////////////////////////////////////////////////////*
*////////////////////////////////////////////////////////////////////////////////////////////////////////////*                                                       *////////////////////////////////////////////////////////////////////////////////////////////////////////////*
*////////////////////////////////////////////////////////////////////////////////////////////////////////////*                                                       *////////////////////////////////////////////////////////////////////////////////////////////////////////////*
*////////////////////////////////////////////////////////////////////////////////////////////////////////////*                                                       *////////////////////////////////////////////////////////////////////////////////////////////////////////////*
*////////////////////////////////////////////////////////////////////////////////////////////////////////////*                                                       *////////////////////////////////////////////////////////////////////////////////////////////////////////////*
*////////////////////////////////////////////////////////////////////////////////////////////////////////////*                                                       *////////////////////////////////////////////////////////////////////////////////////////////////////////////*
*////////////////////////////////////////////////////////////////////////////////////////////////////////////*                                                       *////////////////////////////////////////////////////////////////////////////////////////////////////////////*
*////////////////////////////////////////////////////////////////////////////////////////////////////////////*                                                       *////////////////////////////////////////////////////////////////////////////////////////////////////////////*
*////////////////////////////////////////////////////////////////////////////////////////////////////////////*                                                       *////////////////////////////////////////////////////////////////////////////////////////////////////////////*
*////////////////////////////////////////////////////////////////////////////////////////////////////////////*                                                       *////////////////////////////////////////////////////////////////////////////////////////////////////////////*
*////////////////////////////////////////////////////////////////////////////////////////////////////////////*                                                       *////////////////////////////////////////////////////////////////////////////////////////////////////////////*
*////////////////////////////////////////////////////////////////////////////////////////////////////////////*                                                       *////////////////////////////////////////////////////////////////////////////////////////////////////////////*
*////////////////////////////////////////////////////////////////////////////////////////////////////////////*                                                       *////////////////////////////////////////////////////////////////////////////////////////////////////////////*
*////////////////////////////////////////////////////////////////////////////////////////////////////////////*                                                       *////////////////////////////////////////////////////////////////////////////////////////////////////////////*
*////////////////////////////////////////////////////////////////////////////////////////////////////////////*                                                       *////////////////////////////////////////////////////////////////////////////////////////////////////////////*
*////////////////////////////////////////////////////////////////////////////////////////////////////////////*                                                       *////////////////////////////////////////////////////////////////////////////////////////////////////////////*
*////////////////////////////////////////////////////////////////////////////////////////////////////////////*                                                       *////////////////////////////////////////////////////////////////////////////////////////////////////////////*
*////////////////////////////////////////////////////////////////////////////////////////////////////////////*                                                       *////////////////////////////////////////////////////////////////////////////////////////////////////////////*
*////////////////////////////////////////////////////////////////////////////////////////////////////////////*                                                       *////////////////////////////////////////////////////////////////////////////////////////////////////////////*
*////////////////////////////////////////////////////////////////////////////////////////////////////////////*                                                       *////////////////////////////////////////////////////////////////////////////////////////////////////////////*
*////////////////////////////////////////////////////////////////////////////////////////////////////////////*                                                       *////////////////////////////////////////////////////////////////////////////////////////////////////////////*
*////////////////////////////////////////////////////////////////////////////////////////////////////////////*                                                       *////////////////////////////////////////////////////////////////////////////////////////////////////////////*
*////////////////////////////////////////////////////////////////////////////////////////////////////////////*                                                       *////////////////////////////////////////////////////////////////////////////////////////////////////////////*
*////////////////////////////////////////////////////////////////////////////////////////////////////////////*|||||||||||||||||||||||||||||||||||||||||||||||||||||||*////////////////////////////////////////////////////////////////////////////////////////////////////////////*
*////////////////////////////////////////////////////////////////////////////////////////////////////////////*                                                       *////////////////////////////////////////////////////////////////////////////////////////////////////////////*
*////////////////////////////////////////////////////////////////////////////////////////////////////////////*                                                       *////////////////////////////////////////////////////////////////////////////////////////////////////////////*
*////////////////////////////////////////////////////////////////////////////////////////////////////////////*                                                       *////////////////////////////////////////////////////////////////////////////////////////////////////////////*
*////////////////////////////////////////////////////////////////////////////////////////////////////////////*                                                       *////////////////////////////////////////////////////////////////////////////////////////////////////////////*
*////////////////////////////////////////////////////////////////////////////////////////////////////////////*                                                       *////////////////////////////////////////////////////////////////////////////////////////////////////////////*
*////////////////////////////////////////////////////////////////////////////////////////////////////////////*                                                       *////////////////////////////////////////////////////////////////////////////////////////////////////////////*
*////////////////////////////////////////////////////////////////////////////////////////////////////////////*                                                       *////////////////////////////////////////////////////////////////////////////////////////////////////////////*
*////////////////////////////////////////////////////////////////////////////////////////////////////////////*                                                       *////////////////////////////////////////////////////////////////////////////////////////////////////////////*
*////////////////////////////////////////////////////////////////////////////////////////////////////////////*                                                       *////////////////////////////////////////////////////////////////////////////////////////////////////////////*
*////////////////////////////////////////////////////////////////////////////////////////////////////////////*                                                       *////////////////////////////////////////////////////////////////////////////////////////////////////////////*
*////////////////////////////////////////////////////////////////////////////////////////////////////////////*                                                       *////////////////////////////////////////////////////////////////////////////////////////////////////////////*
*////////////////////////////////////////////////////////////////////////////////////////////////////////////*                                                       *////////////////////////////////////////////////////////////////////////////////////////////////////////////*
*////////////////////////////////////////////////////////////////////////////////////////////////////////////*                                                       *////////////////////////////////////////////////////////////////////////////////////////////////////////////*
*////////////////////////////////////////////////////////////////////////////////////////////////////////////*                                                       *////////////////////////////////////////////////////////////////////////////////////////////////////////////*
*////////////////////////////////////////////////////////////////////////////////////////////////////////////*                                                       *////////////////////////////////////////////////////////////////////////////////////////////////////////////*
*////////////////////////////////////////////////////////////////////////////////////////////////////////////*                                                       *////////////////////////////////////////////////////////////////////////////////////////////////////////////*
*////////////////////////////////////////////////////////////////////////////////////////////////////////////*                                                       *////////////////////////////////////////////////////////////////////////////////////////////////////////////*
*////////////////////////////////////////////////////////////////////////////////////////////////////////////*                                                       *////////////////////////////////////////////////////////////////////////////////////////////////////////////*
*////////////////////////////////////////////////////////////////////////////////////////////////////////////*                                                       *////////////////////////////////////////////////////////////////////////////////////////////////////////////*
*////////////////////////////////////////////////////////////////////////////////////////////////////////////*                                                       *////////////////////////////////////////////////////////////////////////////////////////////////////////////*
*////////////////////////////////////////////////////////////////////////////////////////////////////////////*                                                       *////////////////////////////////////////////////////////////////////////////////////////////////////////////*
*////////////////////////////////////////////////////////////////////////////////////////////////////////////*                                                       *////////////////////////////////////////////////////////////////////////////////////////////////////////////*
*////////////////////////////////////////////////////////////////////////////////////////////////////////////*                                                       *////////////////////////////////////////////////////////////////////////////////////////////////////////////*
*////////////////////////////////////////////////////////////////////////////////////////////////////////////*                                                       *////////////////////////////////////////////////////////////////////////////////////////////////////////////*
*////////////////////////////////////////////////////////////////////////////////////////////////////////////*                                                       *////////////////////////////////////////////////////////////////////////////////////////////////////////////*
*////////////////////////////////////////////////////////////////////////////////////////////////////////////*                                                       *////////////////////////////////////////////////////////////////////////////////////////////////////////////*
**************************************************************************************************************                                                       **************************************************************************************************************
