**********************************************************************************************************************************************                                                                       **********************************************************************************************************************************************
*////////////////////////////////////////////////////////////////////////////////////////////////////////////////////////////////////////////*                                                                       *////////////////////////////////////////////////////////////////////////////////////////////////////////////////////////////////////////////*
*////////////////////////////////////////////////////////////////////////////////////////////////////////////////////////////////////////////*                                                                       *////////////////////////////////////////////////////////////////////////////////////////////////////////////////////////////////////////////*
*////////////////////////////////////////////////////////////////////////////////////////////////////////////////////////////////////////////*                                                                       *////////////////////////////////////////////////////////////////////////////////////////////////////////////////////////////////////////////*
*////////////////////////////////////////////////////////////////////////////////////////////////////////////////////////////////////////////*                                                                       *////////////////////////////////////////////////////////////////////////////////////////////////////////////////////////////////////////////*
*////////////////////////////////////////////////////////////////////////////////////////////////////////////////////////////////////////////*                                                                       *////////////////////////////////////////////////////////////////////////////////////////////////////////////////////////////////////////////*
*////////////////////////////////////////////////////////////////////////////////////////////////////////////////////////////////////////////*                                                                       *////////////////////////////////////////////////////////////////////////////////////////////////////////////////////////////////////////////*
*////////////////////////////////////////////////////////////////////////////////////////////////////////////////////////////////////////////*                                                                       *////////////////////////////////////////////////////////////////////////////////////////////////////////////////////////////////////////////*
*////////////////////////////////////////////////////////////////////////////////////////////////////////////////////////////////////////////*                                                                       *////////////////////////////////////////////////////////////////////////////////////////////////////////////////////////////////////////////*
*////////////////////////////////////////////////////////////////////////////////////////////////////////////////////////////////////////////*                                                                       *////////////////////////////////////////////////////////////////////////////////////////////////////////////////////////////////////////////*
*////////////////////////////////////////////////////////////////////////////////////////////////////////////////////////////////////////////*                                                                       *////////////////////////////////////////////////////////////////////////////////////////////////////////////////////////////////////////////*
*////////////////////////////////////////////////////////////////////////////////////////////////////////////////////////////////////////////*                                                                       *////////////////////////////////////////////////////////////////////////////////////////////////////////////////////////////////////////////*
*////////////////////////////////////////////////////////////////////////////////////////////////////////////////////////////////////////////*                                                                       *////////////////////////////////////////////////////////////////////////////////////////////////////////////////////////////////////////////*
*////////////////////////////////////////////////////////////////////////////////////////////////////////////////////////////////////////////*                                                                       *////////////////////////////////////////////////////////////////////////////////////////////////////////////////////////////////////////////*
*////////////////////////////////////////////////////////////////////////////////////////////////////////////////////////////////////////////*                                                                       *////////////////////////////////////////////////////////////////////////////////////////////////////////////////////////////////////////////*
*////////////////////////////////////////////////////////////////////////////////////////////////////////////////////////////////////////////*                                                                       *////////////////////////////////////////////////////////////////////////////////////////////////////////////////////////////////////////////*
*////////////////////////////////////////////////////////////////////////////////////////////////////////////////////////////////////////////*                                                                       *////////////////////////////////////////////////////////////////////////////////////////////////////////////////////////////////////////////*
*////////////////////////////////////////////////////////////////////////////////////////////////////////////////////////////////////////////*                                                                       *////////////////////////////////////////////////////////////////////////////////////////////////////////////////////////////////////////////*
*////////////////////////////////////////////////////////////////////////////////////////////////////////////////////////////////////////////*                                                                       *////////////////////////////////////////////////////////////////////////////////////////////////////////////////////////////////////////////*
*////////////////////////////////////////////////////////////////////////////////////////////////////////////////////////////////////////////*                                                                       *////////////////////////////////////////////////////////////////////////////////////////////////////////////////////////////////////////////*
*////////////////////////////////////////////////////////////////////////////////////////////////////////////////////////////////////////////*                                                                       *////////////////////////////////////////////////////////////////////////////////////////////////////////////////////////////////////////////*
*////////////////////////////////////////////////////////////////////////////////////////////////////////////////////////////////////////////*                                                                       *////////////////////////////////////////////////////////////////////////////////////////////////////////////////////////////////////////////*
*////////////////////////////////////////////////////////////////////////////////////////////////////////////////////////////////////////////*                                                                       *////////////////////////////////////////////////////////////////////////////////////////////////////////////////////////////////////////////*
*////////////////////////////////////////////////////////////////////////////////////////////////////////////////////////////////////////////*                                                                       *////////////////////////////////////////////////////////////////////////////////////////////////////////////////////////////////////////////*
*////////////////////////////////////////////////////////////////////////////////////////////////////////////////////////////////////////////*                                                                       *////////////////////////////////////////////////////////////////////////////////////////////////////////////////////////////////////////////*
*////////////////////////////////////////////////////////////////////////////////////////////////////////////////////////////////////////////*                                                                       *////////////////////////////////////////////////////////////////////////////////////////////////////////////////////////////////////////////*
*////////////////////////////////////////////////////////////////////////////////////////////////////////////////////////////////////////////*                                                                       *////////////////////////////////////////////////////////////////////////////////////////////////////////////////////////////////////////////*
*////////////////////////////////////////////////////////////////////////////////////////////////////////////////////////////////////////////*                                                                       *////////////////////////////////////////////////////////////////////////////////////////////////////////////////////////////////////////////*
*////////////////////////////////////////////////////////////////////////////////////////////////////////////////////////////////////////////*                                                                       *////////////////////////////////////////////////////////////////////////////////////////////////////////////////////////////////////////////*
*////////////////////////////////////////////////////////////////////////////////////////////////////////////////////////////////////////////*                                                                       *////////////////////////////////////////////////////////////////////////////////////////////////////////////////////////////////////////////*
*////////////////////////////////////////////////////////////////////////////////////////////////////////////////////////////////////////////*                                                                       *////////////////////////////////////////////////////////////////////////////////////////////////////////////////////////////////////////////*
*////////////////////////////////////////////////////////////////////////////////////////////////////////////////////////////////////////////*                                                                       *////////////////////////////////////////////////////////////////////////////////////////////////////////////////////////////////////////////*
*////////////////////////////////////////////////////////////////////////////////////////////////////////////////////////////////////////////*                                                                       *////////////////////////////////////////////////////////////////////////////////////////////////////////////////////////////////////////////*
*////////////////////////////////////////////////////////////////////////////////////////////////////////////////////////////////////////////*                                                                       *////////////////////////////////////////////////////////////////////////////////////////////////////////////////////////////////////////////*
*////////////////////////////////////////////////////////////////////////////////////////////////////////////////////////////////////////////*                                                                       *////////////////////////////////////////////////////////////////////////////////////////////////////////////////////////////////////////////*
*////////////////////////////////////////////////////////////////////////////////////////////////////////////////////////////////////////////*|||||||||||||||||||||||||||||||||||||||||||||||||||||||||||||||||||||||*////////////////////////////////////////////////////////////////////////////////////////////////////////////////////////////////////////////*
*////////////////////////////////////////////////////////////////////////////////////////////////////////////////////////////////////////////*                                                                       *////////////////////////////////////////////////////////////////////////////////////////////////////////////////////////////////////////////*
*////////////////////////////////////////////////////////////////////////////////////////////////////////////////////////////////////////////*                                                                       *////////////////////////////////////////////////////////////////////////////////////////////////////////////////////////////////////////////*
*////////////////////////////////////////////////////////////////////////////////////////////////////////////////////////////////////////////*                                                                       *////////////////////////////////////////////////////////////////////////////////////////////////////////////////////////////////////////////*
*////////////////////////////////////////////////////////////////////////////////////////////////////////////////////////////////////////////*                                                                       *////////////////////////////////////////////////////////////////////////////////////////////////////////////////////////////////////////////*
*////////////////////////////////////////////////////////////////////////////////////////////////////////////////////////////////////////////*                                                                       *////////////////////////////////////////////////////////////////////////////////////////////////////////////////////////////////////////////*
*////////////////////////////////////////////////////////////////////////////////////////////////////////////////////////////////////////////*                                                                       *////////////////////////////////////////////////////////////////////////////////////////////////////////////////////////////////////////////*
*////////////////////////////////////////////////////////////////////////////////////////////////////////////////////////////////////////////*                                                                       *////////////////////////////////////////////////////////////////////////////////////////////////////////////////////////////////////////////*
*////////////////////////////////////////////////////////////////////////////////////////////////////////////////////////////////////////////*                                                                       *////////////////////////////////////////////////////////////////////////////////////////////////////////////////////////////////////////////*
*////////////////////////////////////////////////////////////////////////////////////////////////////////////////////////////////////////////*                                                                       *////////////////////////////////////////////////////////////////////////////////////////////////////////////////////////////////////////////*
*////////////////////////////////////////////////////////////////////////////////////////////////////////////////////////////////////////////*                                                                       *////////////////////////////////////////////////////////////////////////////////////////////////////////////////////////////////////////////*
*////////////////////////////////////////////////////////////////////////////////////////////////////////////////////////////////////////////*                                                                       *////////////////////////////////////////////////////////////////////////////////////////////////////////////////////////////////////////////*
*////////////////////////////////////////////////////////////////////////////////////////////////////////////////////////////////////////////*                                                                       *////////////////////////////////////////////////////////////////////////////////////////////////////////////////////////////////////////////*
*////////////////////////////////////////////////////////////////////////////////////////////////////////////////////////////////////////////*                                                                       *////////////////////////////////////////////////////////////////////////////////////////////////////////////////////////////////////////////*
*////////////////////////////////////////////////////////////////////////////////////////////////////////////////////////////////////////////*                                                                       *////////////////////////////////////////////////////////////////////////////////////////////////////////////////////////////////////////////*
*////////////////////////////////////////////////////////////////////////////////////////////////////////////////////////////////////////////*                                                                       *////////////////////////////////////////////////////////////////////////////////////////////////////////////////////////////////////////////*
*////////////////////////////////////////////////////////////////////////////////////////////////////////////////////////////////////////////*                                                                       *////////////////////////////////////////////////////////////////////////////////////////////////////////////////////////////////////////////*
*////////////////////////////////////////////////////////////////////////////////////////////////////////////////////////////////////////////*                                                                       *////////////////////////////////////////////////////////////////////////////////////////////////////////////////////////////////////////////*
*////////////////////////////////////////////////////////////////////////////////////////////////////////////////////////////////////////////*                                                                       *////////////////////////////////////////////////////////////////////////////////////////////////////////////////////////////////////////////*
*////////////////////////////////////////////////////////////////////////////////////////////////////////////////////////////////////////////*                                                                       *////////////////////////////////////////////////////////////////////////////////////////////////////////////////////////////////////////////*
*////////////////////////////////////////////////////////////////////////////////////////////////////////////////////////////////////////////*                                                                       *////////////////////////////////////////////////////////////////////////////////////////////////////////////////////////////////////////////*
*////////////////////////////////////////////////////////////////////////////////////////////////////////////////////////////////////////////*                                                                       *////////////////////////////////////////////////////////////////////////////////////////////////////////////////////////////////////////////*
*////////////////////////////////////////////////////////////////////////////////////////////////////////////////////////////////////////////*                                                                       *////////////////////////////////////////////////////////////////////////////////////////////////////////////////////////////////////////////*
*////////////////////////////////////////////////////////////////////////////////////////////////////////////////////////////////////////////*                                                                       *////////////////////////////////////////////////////////////////////////////////////////////////////////////////////////////////////////////*
*////////////////////////////////////////////////////////////////////////////////////////////////////////////////////////////////////////////*                                                                       *////////////////////////////////////////////////////////////////////////////////////////////////////////////////////////////////////////////*
*////////////////////////////////////////////////////////////////////////////////////////////////////////////////////////////////////////////*                                                                       *////////////////////////////////////////////////////////////////////////////////////////////////////////////////////////////////////////////*
*////////////////////////////////////////////////////////////////////////////////////////////////////////////////////////////////////////////*                                                                       *////////////////////////////////////////////////////////////////////////////////////////////////////////////////////////////////////////////*
*////////////////////////////////////////////////////////////////////////////////////////////////////////////////////////////////////////////*                                                                       *////////////////////////////////////////////////////////////////////////////////////////////////////////////////////////////////////////////*
*////////////////////////////////////////////////////////////////////////////////////////////////////////////////////////////////////////////*                                                                       *////////////////////////////////////////////////////////////////////////////////////////////////////////////////////////////////////////////*
*////////////////////////////////////////////////////////////////////////////////////////////////////////////////////////////////////////////*                                                                       *////////////////////////////////////////////////////////////////////////////////////////////////////////////////////////////////////////////*
*////////////////////////////////////////////////////////////////////////////////////////////////////////////////////////////////////////////*                                                                       *////////////////////////////////////////////////////////////////////////////////////////////////////////////////////////////////////////////*
*////////////////////////////////////////////////////////////////////////////////////////////////////////////////////////////////////////////*                                                                       *////////////////////////////////////////////////////////////////////////////////////////////////////////////////////////////////////////////*
*////////////////////////////////////////////////////////////////////////////////////////////////////////////////////////////////////////////*                                                                       *////////////////////////////////////////////////////////////////////////////////////////////////////////////////////////////////////////////*
*////////////////////////////////////////////////////////////////////////////////////////////////////////////////////////////////////////////*                                                                       *////////////////////////////////////////////////////////////////////////////////////////////////////////////////////////////////////////////*
*////////////////////////////////////////////////////////////////////////////////////////////////////////////////////////////////////////////*                                                                       *////////////////////////////////////////////////////////////////////////////////////////////////////////////////////////////////////////////*
**********************************************************************************************************************************************                                                                       **********************************************************************************************************************************************
