******************************************************************                                 ******************************************************************
*////////////////////////////////////////////////////////////////*                                 *////////////////////////////////////////////////////////////////*
*////////////////////////////////////////////////////////////////*                                 *////////////////////////////////////////////////////////////////*
*////////////////////////////////////////////////////////////////*                                 *////////////////////////////////////////////////////////////////*
*////////////////////////////////////////////////////////////////*                                 *////////////////////////////////////////////////////////////////*
*////////////////////////////////////////////////////////////////*                                 *////////////////////////////////////////////////////////////////*
*////////////////////////////////////////////////////////////////*                                 *////////////////////////////////////////////////////////////////*
*////////////////////////////////////////////////////////////////*                                 *////////////////////////////////////////////////////////////////*
*////////////////////////////////////////////////////////////////*                                 *////////////////////////////////////////////////////////////////*
*////////////////////////////////////////////////////////////////*                                 *////////////////////////////////////////////////////////////////*
*////////////////////////////////////////////////////////////////*                                 *////////////////////////////////////////////////////////////////*
*////////////////////////////////////////////////////////////////*                                 *////////////////////////////////////////////////////////////////*
*////////////////////////////////////////////////////////////////*                                 *////////////////////////////////////////////////////////////////*
*////////////////////////////////////////////////////////////////*                                 *////////////////////////////////////////////////////////////////*
*////////////////////////////////////////////////////////////////*                                 *////////////////////////////////////////////////////////////////*
*////////////////////////////////////////////////////////////////*                                 *////////////////////////////////////////////////////////////////*
*////////////////////////////////////////////////////////////////*|||||||||||||||||||||||||||||||||*////////////////////////////////////////////////////////////////*
*////////////////////////////////////////////////////////////////*                                 *////////////////////////////////////////////////////////////////*
*////////////////////////////////////////////////////////////////*                                 *////////////////////////////////////////////////////////////////*
*////////////////////////////////////////////////////////////////*                                 *////////////////////////////////////////////////////////////////*
*////////////////////////////////////////////////////////////////*                                 *////////////////////////////////////////////////////////////////*
*////////////////////////////////////////////////////////////////*                                 *////////////////////////////////////////////////////////////////*
*////////////////////////////////////////////////////////////////*                                 *////////////////////////////////////////////////////////////////*
*////////////////////////////////////////////////////////////////*                                 *////////////////////////////////////////////////////////////////*
*////////////////////////////////////////////////////////////////*                                 *////////////////////////////////////////////////////////////////*
*////////////////////////////////////////////////////////////////*                                 *////////////////////////////////////////////////////////////////*
*////////////////////////////////////////////////////////////////*                                 *////////////////////////////////////////////////////////////////*
*////////////////////////////////////////////////////////////////*                                 *////////////////////////////////////////////////////////////////*
*////////////////////////////////////////////////////////////////*                                 *////////////////////////////////////////////////////////////////*
*////////////////////////////////////////////////////////////////*                                 *////////////////////////////////////////////////////////////////*
*////////////////////////////////////////////////////////////////*                                 *////////////////////////////////////////////////////////////////*
*////////////////////////////////////////////////////////////////*                                 *////////////////////////////////////////////////////////////////*
******************************************************************                                 ******************************************************************
