**********************************************                       **********************************************
*////////////////////////////////////////////*                       *////////////////////////////////////////////*
*////////////////////////////////////////////*                       *////////////////////////////////////////////*
*////////////////////////////////////////////*                       *////////////////////////////////////////////*
*////////////////////////////////////////////*                       *////////////////////////////////////////////*
*////////////////////////////////////////////*                       *////////////////////////////////////////////*
*////////////////////////////////////////////*                       *////////////////////////////////////////////*
*////////////////////////////////////////////*                       *////////////////////////////////////////////*
*////////////////////////////////////////////*                       *////////////////////////////////////////////*
*////////////////////////////////////////////*                       *////////////////////////////////////////////*
*////////////////////////////////////////////*                       *////////////////////////////////////////////*
*////////////////////////////////////////////*|||||||||||||||||||||||*////////////////////////////////////////////*
*////////////////////////////////////////////*                       *////////////////////////////////////////////*
*////////////////////////////////////////////*                       *////////////////////////////////////////////*
*////////////////////////////////////////////*                       *////////////////////////////////////////////*
*////////////////////////////////////////////*                       *////////////////////////////////////////////*
*////////////////////////////////////////////*                       *////////////////////////////////////////////*
*////////////////////////////////////////////*                       *////////////////////////////////////////////*
*////////////////////////////////////////////*                       *////////////////////////////////////////////*
*////////////////////////////////////////////*                       *////////////////////////////////////////////*
*////////////////////////////////////////////*                       *////////////////////////////////////////////*
*////////////////////////////////////////////*                       *////////////////////////////////////////////*
**********************************************                       **********************************************
