**********     **********
*////////*     *////////*
*////////*|||||*////////*
*////////*     *////////*
**********     **********
