**************************************************                         **************************************************
*////////////////////////////////////////////////*                         *////////////////////////////////////////////////*
*////////////////////////////////////////////////*                         *////////////////////////////////////////////////*
*////////////////////////////////////////////////*                         *////////////////////////////////////////////////*
*////////////////////////////////////////////////*                         *////////////////////////////////////////////////*
*////////////////////////////////////////////////*                         *////////////////////////////////////////////////*
*////////////////////////////////////////////////*                         *////////////////////////////////////////////////*
*////////////////////////////////////////////////*                         *////////////////////////////////////////////////*
*////////////////////////////////////////////////*                         *////////////////////////////////////////////////*
*////////////////////////////////////////////////*                         *////////////////////////////////////////////////*
*////////////////////////////////////////////////*                         *////////////////////////////////////////////////*
*////////////////////////////////////////////////*                         *////////////////////////////////////////////////*
*////////////////////////////////////////////////*|||||||||||||||||||||||||*////////////////////////////////////////////////*
*////////////////////////////////////////////////*                         *////////////////////////////////////////////////*
*////////////////////////////////////////////////*                         *////////////////////////////////////////////////*
*////////////////////////////////////////////////*                         *////////////////////////////////////////////////*
*////////////////////////////////////////////////*                         *////////////////////////////////////////////////*
*////////////////////////////////////////////////*                         *////////////////////////////////////////////////*
*////////////////////////////////////////////////*                         *////////////////////////////////////////////////*
*////////////////////////////////////////////////*                         *////////////////////////////////////////////////*
*////////////////////////////////////////////////*                         *////////////////////////////////////////////////*
*////////////////////////////////////////////////*                         *////////////////////////////////////////////////*
*////////////////////////////////////////////////*                         *////////////////////////////////////////////////*
*////////////////////////////////////////////////*                         *////////////////////////////////////////////////*
**************************************************                         **************************************************
