******************         ******************
*////////////////*         *////////////////*
*////////////////*         *////////////////*
*////////////////*         *////////////////*
*////////////////*|||||||||*////////////////*
*////////////////*         *////////////////*
*////////////////*         *////////////////*
*////////////////*         *////////////////*
******************         ******************
