**************************************************************************************************************************************                                                                   **************************************************************************************************************************************
*////////////////////////////////////////////////////////////////////////////////////////////////////////////////////////////////////*                                                                   *////////////////////////////////////////////////////////////////////////////////////////////////////////////////////////////////////*
*////////////////////////////////////////////////////////////////////////////////////////////////////////////////////////////////////*                                                                   *////////////////////////////////////////////////////////////////////////////////////////////////////////////////////////////////////*
*////////////////////////////////////////////////////////////////////////////////////////////////////////////////////////////////////*                                                                   *////////////////////////////////////////////////////////////////////////////////////////////////////////////////////////////////////*
*////////////////////////////////////////////////////////////////////////////////////////////////////////////////////////////////////*                                                                   *////////////////////////////////////////////////////////////////////////////////////////////////////////////////////////////////////*
*////////////////////////////////////////////////////////////////////////////////////////////////////////////////////////////////////*                                                                   *////////////////////////////////////////////////////////////////////////////////////////////////////////////////////////////////////*
*////////////////////////////////////////////////////////////////////////////////////////////////////////////////////////////////////*                                                                   *////////////////////////////////////////////////////////////////////////////////////////////////////////////////////////////////////*
*////////////////////////////////////////////////////////////////////////////////////////////////////////////////////////////////////*                                                                   *////////////////////////////////////////////////////////////////////////////////////////////////////////////////////////////////////*
*////////////////////////////////////////////////////////////////////////////////////////////////////////////////////////////////////*                                                                   *////////////////////////////////////////////////////////////////////////////////////////////////////////////////////////////////////*
*////////////////////////////////////////////////////////////////////////////////////////////////////////////////////////////////////*                                                                   *////////////////////////////////////////////////////////////////////////////////////////////////////////////////////////////////////*
*////////////////////////////////////////////////////////////////////////////////////////////////////////////////////////////////////*                                                                   *////////////////////////////////////////////////////////////////////////////////////////////////////////////////////////////////////*
*////////////////////////////////////////////////////////////////////////////////////////////////////////////////////////////////////*                                                                   *////////////////////////////////////////////////////////////////////////////////////////////////////////////////////////////////////*
*////////////////////////////////////////////////////////////////////////////////////////////////////////////////////////////////////*                                                                   *////////////////////////////////////////////////////////////////////////////////////////////////////////////////////////////////////*
*////////////////////////////////////////////////////////////////////////////////////////////////////////////////////////////////////*                                                                   *////////////////////////////////////////////////////////////////////////////////////////////////////////////////////////////////////*
*////////////////////////////////////////////////////////////////////////////////////////////////////////////////////////////////////*                                                                   *////////////////////////////////////////////////////////////////////////////////////////////////////////////////////////////////////*
*////////////////////////////////////////////////////////////////////////////////////////////////////////////////////////////////////*                                                                   *////////////////////////////////////////////////////////////////////////////////////////////////////////////////////////////////////*
*////////////////////////////////////////////////////////////////////////////////////////////////////////////////////////////////////*                                                                   *////////////////////////////////////////////////////////////////////////////////////////////////////////////////////////////////////*
*////////////////////////////////////////////////////////////////////////////////////////////////////////////////////////////////////*                                                                   *////////////////////////////////////////////////////////////////////////////////////////////////////////////////////////////////////*
*////////////////////////////////////////////////////////////////////////////////////////////////////////////////////////////////////*                                                                   *////////////////////////////////////////////////////////////////////////////////////////////////////////////////////////////////////*
*////////////////////////////////////////////////////////////////////////////////////////////////////////////////////////////////////*                                                                   *////////////////////////////////////////////////////////////////////////////////////////////////////////////////////////////////////*
*////////////////////////////////////////////////////////////////////////////////////////////////////////////////////////////////////*                                                                   *////////////////////////////////////////////////////////////////////////////////////////////////////////////////////////////////////*
*////////////////////////////////////////////////////////////////////////////////////////////////////////////////////////////////////*                                                                   *////////////////////////////////////////////////////////////////////////////////////////////////////////////////////////////////////*
*////////////////////////////////////////////////////////////////////////////////////////////////////////////////////////////////////*                                                                   *////////////////////////////////////////////////////////////////////////////////////////////////////////////////////////////////////*
*////////////////////////////////////////////////////////////////////////////////////////////////////////////////////////////////////*                                                                   *////////////////////////////////////////////////////////////////////////////////////////////////////////////////////////////////////*
*////////////////////////////////////////////////////////////////////////////////////////////////////////////////////////////////////*                                                                   *////////////////////////////////////////////////////////////////////////////////////////////////////////////////////////////////////*
*////////////////////////////////////////////////////////////////////////////////////////////////////////////////////////////////////*                                                                   *////////////////////////////////////////////////////////////////////////////////////////////////////////////////////////////////////*
*////////////////////////////////////////////////////////////////////////////////////////////////////////////////////////////////////*                                                                   *////////////////////////////////////////////////////////////////////////////////////////////////////////////////////////////////////*
*////////////////////////////////////////////////////////////////////////////////////////////////////////////////////////////////////*                                                                   *////////////////////////////////////////////////////////////////////////////////////////////////////////////////////////////////////*
*////////////////////////////////////////////////////////////////////////////////////////////////////////////////////////////////////*                                                                   *////////////////////////////////////////////////////////////////////////////////////////////////////////////////////////////////////*
*////////////////////////////////////////////////////////////////////////////////////////////////////////////////////////////////////*                                                                   *////////////////////////////////////////////////////////////////////////////////////////////////////////////////////////////////////*
*////////////////////////////////////////////////////////////////////////////////////////////////////////////////////////////////////*                                                                   *////////////////////////////////////////////////////////////////////////////////////////////////////////////////////////////////////*
*////////////////////////////////////////////////////////////////////////////////////////////////////////////////////////////////////*                                                                   *////////////////////////////////////////////////////////////////////////////////////////////////////////////////////////////////////*
*////////////////////////////////////////////////////////////////////////////////////////////////////////////////////////////////////*                                                                   *////////////////////////////////////////////////////////////////////////////////////////////////////////////////////////////////////*
*////////////////////////////////////////////////////////////////////////////////////////////////////////////////////////////////////*|||||||||||||||||||||||||||||||||||||||||||||||||||||||||||||||||||*////////////////////////////////////////////////////////////////////////////////////////////////////////////////////////////////////*
*////////////////////////////////////////////////////////////////////////////////////////////////////////////////////////////////////*                                                                   *////////////////////////////////////////////////////////////////////////////////////////////////////////////////////////////////////*
*////////////////////////////////////////////////////////////////////////////////////////////////////////////////////////////////////*                                                                   *////////////////////////////////////////////////////////////////////////////////////////////////////////////////////////////////////*
*////////////////////////////////////////////////////////////////////////////////////////////////////////////////////////////////////*                                                                   *////////////////////////////////////////////////////////////////////////////////////////////////////////////////////////////////////*
*////////////////////////////////////////////////////////////////////////////////////////////////////////////////////////////////////*                                                                   *////////////////////////////////////////////////////////////////////////////////////////////////////////////////////////////////////*
*////////////////////////////////////////////////////////////////////////////////////////////////////////////////////////////////////*                                                                   *////////////////////////////////////////////////////////////////////////////////////////////////////////////////////////////////////*
*////////////////////////////////////////////////////////////////////////////////////////////////////////////////////////////////////*                                                                   *////////////////////////////////////////////////////////////////////////////////////////////////////////////////////////////////////*
*////////////////////////////////////////////////////////////////////////////////////////////////////////////////////////////////////*                                                                   *////////////////////////////////////////////////////////////////////////////////////////////////////////////////////////////////////*
*////////////////////////////////////////////////////////////////////////////////////////////////////////////////////////////////////*                                                                   *////////////////////////////////////////////////////////////////////////////////////////////////////////////////////////////////////*
*////////////////////////////////////////////////////////////////////////////////////////////////////////////////////////////////////*                                                                   *////////////////////////////////////////////////////////////////////////////////////////////////////////////////////////////////////*
*////////////////////////////////////////////////////////////////////////////////////////////////////////////////////////////////////*                                                                   *////////////////////////////////////////////////////////////////////////////////////////////////////////////////////////////////////*
*////////////////////////////////////////////////////////////////////////////////////////////////////////////////////////////////////*                                                                   *////////////////////////////////////////////////////////////////////////////////////////////////////////////////////////////////////*
*////////////////////////////////////////////////////////////////////////////////////////////////////////////////////////////////////*                                                                   *////////////////////////////////////////////////////////////////////////////////////////////////////////////////////////////////////*
*////////////////////////////////////////////////////////////////////////////////////////////////////////////////////////////////////*                                                                   *////////////////////////////////////////////////////////////////////////////////////////////////////////////////////////////////////*
*////////////////////////////////////////////////////////////////////////////////////////////////////////////////////////////////////*                                                                   *////////////////////////////////////////////////////////////////////////////////////////////////////////////////////////////////////*
*////////////////////////////////////////////////////////////////////////////////////////////////////////////////////////////////////*                                                                   *////////////////////////////////////////////////////////////////////////////////////////////////////////////////////////////////////*
*////////////////////////////////////////////////////////////////////////////////////////////////////////////////////////////////////*                                                                   *////////////////////////////////////////////////////////////////////////////////////////////////////////////////////////////////////*
*////////////////////////////////////////////////////////////////////////////////////////////////////////////////////////////////////*                                                                   *////////////////////////////////////////////////////////////////////////////////////////////////////////////////////////////////////*
*////////////////////////////////////////////////////////////////////////////////////////////////////////////////////////////////////*                                                                   *////////////////////////////////////////////////////////////////////////////////////////////////////////////////////////////////////*
*////////////////////////////////////////////////////////////////////////////////////////////////////////////////////////////////////*                                                                   *////////////////////////////////////////////////////////////////////////////////////////////////////////////////////////////////////*
*////////////////////////////////////////////////////////////////////////////////////////////////////////////////////////////////////*                                                                   *////////////////////////////////////////////////////////////////////////////////////////////////////////////////////////////////////*
*////////////////////////////////////////////////////////////////////////////////////////////////////////////////////////////////////*                                                                   *////////////////////////////////////////////////////////////////////////////////////////////////////////////////////////////////////*
*////////////////////////////////////////////////////////////////////////////////////////////////////////////////////////////////////*                                                                   *////////////////////////////////////////////////////////////////////////////////////////////////////////////////////////////////////*
*////////////////////////////////////////////////////////////////////////////////////////////////////////////////////////////////////*                                                                   *////////////////////////////////////////////////////////////////////////////////////////////////////////////////////////////////////*
*////////////////////////////////////////////////////////////////////////////////////////////////////////////////////////////////////*                                                                   *////////////////////////////////////////////////////////////////////////////////////////////////////////////////////////////////////*
*////////////////////////////////////////////////////////////////////////////////////////////////////////////////////////////////////*                                                                   *////////////////////////////////////////////////////////////////////////////////////////////////////////////////////////////////////*
*////////////////////////////////////////////////////////////////////////////////////////////////////////////////////////////////////*                                                                   *////////////////////////////////////////////////////////////////////////////////////////////////////////////////////////////////////*
*////////////////////////////////////////////////////////////////////////////////////////////////////////////////////////////////////*                                                                   *////////////////////////////////////////////////////////////////////////////////////////////////////////////////////////////////////*
*////////////////////////////////////////////////////////////////////////////////////////////////////////////////////////////////////*                                                                   *////////////////////////////////////////////////////////////////////////////////////////////////////////////////////////////////////*
*////////////////////////////////////////////////////////////////////////////////////////////////////////////////////////////////////*                                                                   *////////////////////////////////////////////////////////////////////////////////////////////////////////////////////////////////////*
*////////////////////////////////////////////////////////////////////////////////////////////////////////////////////////////////////*                                                                   *////////////////////////////////////////////////////////////////////////////////////////////////////////////////////////////////////*
*////////////////////////////////////////////////////////////////////////////////////////////////////////////////////////////////////*                                                                   *////////////////////////////////////////////////////////////////////////////////////////////////////////////////////////////////////*
*////////////////////////////////////////////////////////////////////////////////////////////////////////////////////////////////////*                                                                   *////////////////////////////////////////////////////////////////////////////////////////////////////////////////////////////////////*
**************************************************************************************************************************************                                                                   **************************************************************************************************************************************
