**************************************                   **************************************
*////////////////////////////////////*                   *////////////////////////////////////*
*////////////////////////////////////*                   *////////////////////////////////////*
*////////////////////////////////////*                   *////////////////////////////////////*
*////////////////////////////////////*                   *////////////////////////////////////*
*////////////////////////////////////*                   *////////////////////////////////////*
*////////////////////////////////////*                   *////////////////////////////////////*
*////////////////////////////////////*                   *////////////////////////////////////*
*////////////////////////////////////*                   *////////////////////////////////////*
*////////////////////////////////////*|||||||||||||||||||*////////////////////////////////////*
*////////////////////////////////////*                   *////////////////////////////////////*
*////////////////////////////////////*                   *////////////////////////////////////*
*////////////////////////////////////*                   *////////////////////////////////////*
*////////////////////////////////////*                   *////////////////////////////////////*
*////////////////////////////////////*                   *////////////////////////////////////*
*////////////////////////////////////*                   *////////////////////////////////////*
*////////////////////////////////////*                   *////////////////////////////////////*
*////////////////////////////////////*                   *////////////////////////////////////*
**************************************                   **************************************
