**************************             **************************
*////////////////////////*             *////////////////////////*
*////////////////////////*             *////////////////////////*
*////////////////////////*             *////////////////////////*
*////////////////////////*             *////////////////////////*
*////////////////////////*             *////////////////////////*
*////////////////////////*|||||||||||||*////////////////////////*
*////////////////////////*             *////////////////////////*
*////////////////////////*             *////////////////////////*
*////////////////////////*             *////////////////////////*
*////////////////////////*             *////////////////////////*
*////////////////////////*             *////////////////////////*
**************************             **************************
