******************************               ******************************
*////////////////////////////*               *////////////////////////////*
*////////////////////////////*               *////////////////////////////*
*////////////////////////////*               *////////////////////////////*
*////////////////////////////*               *////////////////////////////*
*////////////////////////////*               *////////////////////////////*
*////////////////////////////*               *////////////////////////////*
*////////////////////////////*|||||||||||||||*////////////////////////////*
*////////////////////////////*               *////////////////////////////*
*////////////////////////////*               *////////////////////////////*
*////////////////////////////*               *////////////////////////////*
*////////////////////////////*               *////////////////////////////*
*////////////////////////////*               *////////////////////////////*
*////////////////////////////*               *////////////////////////////*
******************************               ******************************
