**************************************************************************************************************************                                                             **************************************************************************************************************************
*////////////////////////////////////////////////////////////////////////////////////////////////////////////////////////*                                                             *////////////////////////////////////////////////////////////////////////////////////////////////////////////////////////*
*////////////////////////////////////////////////////////////////////////////////////////////////////////////////////////*                                                             *////////////////////////////////////////////////////////////////////////////////////////////////////////////////////////*
*////////////////////////////////////////////////////////////////////////////////////////////////////////////////////////*                                                             *////////////////////////////////////////////////////////////////////////////////////////////////////////////////////////*
*////////////////////////////////////////////////////////////////////////////////////////////////////////////////////////*                                                             *////////////////////////////////////////////////////////////////////////////////////////////////////////////////////////*
*////////////////////////////////////////////////////////////////////////////////////////////////////////////////////////*                                                             *////////////////////////////////////////////////////////////////////////////////////////////////////////////////////////*
*////////////////////////////////////////////////////////////////////////////////////////////////////////////////////////*                                                             *////////////////////////////////////////////////////////////////////////////////////////////////////////////////////////*
*////////////////////////////////////////////////////////////////////////////////////////////////////////////////////////*                                                             *////////////////////////////////////////////////////////////////////////////////////////////////////////////////////////*
*////////////////////////////////////////////////////////////////////////////////////////////////////////////////////////*                                                             *////////////////////////////////////////////////////////////////////////////////////////////////////////////////////////*
*////////////////////////////////////////////////////////////////////////////////////////////////////////////////////////*                                                             *////////////////////////////////////////////////////////////////////////////////////////////////////////////////////////*
*////////////////////////////////////////////////////////////////////////////////////////////////////////////////////////*                                                             *////////////////////////////////////////////////////////////////////////////////////////////////////////////////////////*
*////////////////////////////////////////////////////////////////////////////////////////////////////////////////////////*                                                             *////////////////////////////////////////////////////////////////////////////////////////////////////////////////////////*
*////////////////////////////////////////////////////////////////////////////////////////////////////////////////////////*                                                             *////////////////////////////////////////////////////////////////////////////////////////////////////////////////////////*
*////////////////////////////////////////////////////////////////////////////////////////////////////////////////////////*                                                             *////////////////////////////////////////////////////////////////////////////////////////////////////////////////////////*
*////////////////////////////////////////////////////////////////////////////////////////////////////////////////////////*                                                             *////////////////////////////////////////////////////////////////////////////////////////////////////////////////////////*
*////////////////////////////////////////////////////////////////////////////////////////////////////////////////////////*                                                             *////////////////////////////////////////////////////////////////////////////////////////////////////////////////////////*
*////////////////////////////////////////////////////////////////////////////////////////////////////////////////////////*                                                             *////////////////////////////////////////////////////////////////////////////////////////////////////////////////////////*
*////////////////////////////////////////////////////////////////////////////////////////////////////////////////////////*                                                             *////////////////////////////////////////////////////////////////////////////////////////////////////////////////////////*
*////////////////////////////////////////////////////////////////////////////////////////////////////////////////////////*                                                             *////////////////////////////////////////////////////////////////////////////////////////////////////////////////////////*
*////////////////////////////////////////////////////////////////////////////////////////////////////////////////////////*                                                             *////////////////////////////////////////////////////////////////////////////////////////////////////////////////////////*
*////////////////////////////////////////////////////////////////////////////////////////////////////////////////////////*                                                             *////////////////////////////////////////////////////////////////////////////////////////////////////////////////////////*
*////////////////////////////////////////////////////////////////////////////////////////////////////////////////////////*                                                             *////////////////////////////////////////////////////////////////////////////////////////////////////////////////////////*
*////////////////////////////////////////////////////////////////////////////////////////////////////////////////////////*                                                             *////////////////////////////////////////////////////////////////////////////////////////////////////////////////////////*
*////////////////////////////////////////////////////////////////////////////////////////////////////////////////////////*                                                             *////////////////////////////////////////////////////////////////////////////////////////////////////////////////////////*
*////////////////////////////////////////////////////////////////////////////////////////////////////////////////////////*                                                             *////////////////////////////////////////////////////////////////////////////////////////////////////////////////////////*
*////////////////////////////////////////////////////////////////////////////////////////////////////////////////////////*                                                             *////////////////////////////////////////////////////////////////////////////////////////////////////////////////////////*
*////////////////////////////////////////////////////////////////////////////////////////////////////////////////////////*                                                             *////////////////////////////////////////////////////////////////////////////////////////////////////////////////////////*
*////////////////////////////////////////////////////////////////////////////////////////////////////////////////////////*                                                             *////////////////////////////////////////////////////////////////////////////////////////////////////////////////////////*
*////////////////////////////////////////////////////////////////////////////////////////////////////////////////////////*                                                             *////////////////////////////////////////////////////////////////////////////////////////////////////////////////////////*
*////////////////////////////////////////////////////////////////////////////////////////////////////////////////////////*                                                             *////////////////////////////////////////////////////////////////////////////////////////////////////////////////////////*
*////////////////////////////////////////////////////////////////////////////////////////////////////////////////////////*|||||||||||||||||||||||||||||||||||||||||||||||||||||||||||||*////////////////////////////////////////////////////////////////////////////////////////////////////////////////////////*
*////////////////////////////////////////////////////////////////////////////////////////////////////////////////////////*                                                             *////////////////////////////////////////////////////////////////////////////////////////////////////////////////////////*
*////////////////////////////////////////////////////////////////////////////////////////////////////////////////////////*                                                             *////////////////////////////////////////////////////////////////////////////////////////////////////////////////////////*
*////////////////////////////////////////////////////////////////////////////////////////////////////////////////////////*                                                             *////////////////////////////////////////////////////////////////////////////////////////////////////////////////////////*
*////////////////////////////////////////////////////////////////////////////////////////////////////////////////////////*                                                             *////////////////////////////////////////////////////////////////////////////////////////////////////////////////////////*
*////////////////////////////////////////////////////////////////////////////////////////////////////////////////////////*                                                             *////////////////////////////////////////////////////////////////////////////////////////////////////////////////////////*
*////////////////////////////////////////////////////////////////////////////////////////////////////////////////////////*                                                             *////////////////////////////////////////////////////////////////////////////////////////////////////////////////////////*
*////////////////////////////////////////////////////////////////////////////////////////////////////////////////////////*                                                             *////////////////////////////////////////////////////////////////////////////////////////////////////////////////////////*
*////////////////////////////////////////////////////////////////////////////////////////////////////////////////////////*                                                             *////////////////////////////////////////////////////////////////////////////////////////////////////////////////////////*
*////////////////////////////////////////////////////////////////////////////////////////////////////////////////////////*                                                             *////////////////////////////////////////////////////////////////////////////////////////////////////////////////////////*
*////////////////////////////////////////////////////////////////////////////////////////////////////////////////////////*                                                             *////////////////////////////////////////////////////////////////////////////////////////////////////////////////////////*
*////////////////////////////////////////////////////////////////////////////////////////////////////////////////////////*                                                             *////////////////////////////////////////////////////////////////////////////////////////////////////////////////////////*
*////////////////////////////////////////////////////////////////////////////////////////////////////////////////////////*                                                             *////////////////////////////////////////////////////////////////////////////////////////////////////////////////////////*
*////////////////////////////////////////////////////////////////////////////////////////////////////////////////////////*                                                             *////////////////////////////////////////////////////////////////////////////////////////////////////////////////////////*
*////////////////////////////////////////////////////////////////////////////////////////////////////////////////////////*                                                             *////////////////////////////////////////////////////////////////////////////////////////////////////////////////////////*
*////////////////////////////////////////////////////////////////////////////////////////////////////////////////////////*                                                             *////////////////////////////////////////////////////////////////////////////////////////////////////////////////////////*
*////////////////////////////////////////////////////////////////////////////////////////////////////////////////////////*                                                             *////////////////////////////////////////////////////////////////////////////////////////////////////////////////////////*
*////////////////////////////////////////////////////////////////////////////////////////////////////////////////////////*                                                             *////////////////////////////////////////////////////////////////////////////////////////////////////////////////////////*
*////////////////////////////////////////////////////////////////////////////////////////////////////////////////////////*                                                             *////////////////////////////////////////////////////////////////////////////////////////////////////////////////////////*
*////////////////////////////////////////////////////////////////////////////////////////////////////////////////////////*                                                             *////////////////////////////////////////////////////////////////////////////////////////////////////////////////////////*
*////////////////////////////////////////////////////////////////////////////////////////////////////////////////////////*                                                             *////////////////////////////////////////////////////////////////////////////////////////////////////////////////////////*
*////////////////////////////////////////////////////////////////////////////////////////////////////////////////////////*                                                             *////////////////////////////////////////////////////////////////////////////////////////////////////////////////////////*
*////////////////////////////////////////////////////////////////////////////////////////////////////////////////////////*                                                             *////////////////////////////////////////////////////////////////////////////////////////////////////////////////////////*
*////////////////////////////////////////////////////////////////////////////////////////////////////////////////////////*                                                             *////////////////////////////////////////////////////////////////////////////////////////////////////////////////////////*
*////////////////////////////////////////////////////////////////////////////////////////////////////////////////////////*                                                             *////////////////////////////////////////////////////////////////////////////////////////////////////////////////////////*
*////////////////////////////////////////////////////////////////////////////////////////////////////////////////////////*                                                             *////////////////////////////////////////////////////////////////////////////////////////////////////////////////////////*
*////////////////////////////////////////////////////////////////////////////////////////////////////////////////////////*                                                             *////////////////////////////////////////////////////////////////////////////////////////////////////////////////////////*
*////////////////////////////////////////////////////////////////////////////////////////////////////////////////////////*                                                             *////////////////////////////////////////////////////////////////////////////////////////////////////////////////////////*
*////////////////////////////////////////////////////////////////////////////////////////////////////////////////////////*                                                             *////////////////////////////////////////////////////////////////////////////////////////////////////////////////////////*
*////////////////////////////////////////////////////////////////////////////////////////////////////////////////////////*                                                             *////////////////////////////////////////////////////////////////////////////////////////////////////////////////////////*
**************************************************************************************************************************                                                             **************************************************************************************************************************
